,price,bedrooms,bathrooms,sqft_living,floors,sqft_above,sqft_basement,yr_built
0,313000.0,3.0,1.5,1340,1.5,1340,0,1955
2,342000.0,3.0,2.0,1930,1.0,1930,0,1966
3,420000.0,3.0,2.25,2000,1.0,1000,1000,1963
4,550000.0,4.0,2.5,1940,1.0,1140,800,1976
5,490000.0,2.0,1.0,880,1.0,880,0,1938
6,335000.0,2.0,2.0,1350,1.0,1350,0,1976
7,482000.0,4.0,2.5,2710,2.0,2710,0,1989
8,452500.0,3.0,2.5,2430,1.0,1570,860,1985
9,640000.0,4.0,2.0,1520,1.5,1520,0,1945
10,463000.0,3.0,1.75,1710,1.0,1710,0,1948
12,588500.0,3.0,1.75,2330,1.0,1970,360,1980
13,365000.0,3.0,1.0,1090,1.0,1090,0,1955
14,1200000.0,5.0,2.75,2910,1.5,2910,0,1939
15,242500.0,3.0,1.5,1200,1.0,1200,0,1965
16,419000.0,3.0,1.5,1570,1.0,1570,0,1956
17,367500.0,4.0,3.0,3110,2.0,3110,0,1997
18,257950.0,3.0,1.75,1370,1.0,1370,0,1987
19,275000.0,3.0,1.5,1180,1.0,1180,0,1983
20,750000.0,3.0,1.75,2240,2.0,1550,690,1923
21,435000.0,4.0,1.0,1450,1.0,1450,0,1954
22,626000.0,3.0,2.25,1750,2.5,1470,280,2005
23,612500.0,4.0,2.5,2730,2.0,2730,0,1991
24,495000.0,4.0,1.75,1600,1.0,1130,470,1959
25,285000.0,3.0,2.5,2090,1.0,1360,730,1987
26,615000.0,3.0,1.75,2360,1.0,1360,1000,1948
27,698000.0,4.0,2.25,2200,1.5,1300,900,1920
28,675000.0,5.0,2.5,2820,2.0,2820,0,1979
29,790000.0,3.0,2.5,2600,1.0,1700,900,1951
30,382500.0,4.0,1.75,1560,1.0,1560,0,1967
31,499950.0,4.0,2.5,2860,2.0,2190,670,2004
32,650000.0,4.0,2.0,1820,1.5,1640,180,1945
33,625000.0,4.0,2.5,2820,2.0,2820,0,2014
34,400000.0,4.0,2.5,3630,1.5,2300,1330,1979
35,604000.0,3.0,2.5,3240,2.0,3240,0,1995
36,440000.0,2.0,1.0,800,1.0,800,0,1944
37,287200.0,3.0,3.0,1850,1.0,1090,760,1992
38,403000.0,3.0,2.0,1960,1.0,1650,310,1957
39,750000.0,3.0,2.5,2390,1.0,1440,950,1955
40,335000.0,3.0,2.25,1580,1.0,1580,0,1978
41,260000.0,4.0,2.0,1480,1.0,1480,0,1974
42,308500.0,2.0,1.0,850,1.0,850,0,1950
43,439950.0,3.0,2.5,1770,2.0,1770,0,1990
44,235000.0,2.0,1.0,1210,1.0,1210,0,1949
45,315000.0,3.0,1.0,1160,1.0,1160,0,1968
46,437500.0,3.0,2.25,1970,2.0,1970,0,1977
47,407500.0,3.0,2.5,1930,2.0,1930,0,1996
48,445700.0,3.0,2.5,1270,3.0,1270,0,2001
49,838000.0,4.0,2.5,3310,2.0,3310,0,2001
50,630000.0,4.0,2.75,2710,2.0,2710,0,2000
51,550000.0,3.0,1.75,2910,1.5,2910,0,1979
52,805000.0,3.0,2.0,2710,1.5,1880,830,1929
53,284000.0,3.0,1.75,1800,1.0,1800,0,1968
54,470000.0,5.0,2.5,2210,1.0,1460,750,1976
55,430000.0,4.0,1.5,1920,1.0,1070,850,1954
56,491500.0,4.0,1.75,2190,1.0,2190,0,1968
57,785000.0,5.0,3.25,3660,2.0,3660,0,2006
58,385000.0,3.0,3.25,1320,2.0,1040,280,2008
59,295000.0,2.0,2.5,1630,2.0,1280,350,2009
60,555000.0,4.0,2.5,3310,2.0,3310,0,2012
61,459990.0,3.0,2.5,2680,2.0,2680,0,2013
62,625000.0,4.0,3.25,2730,1.0,1560,1170,2007
63,300000.0,3.0,2.5,2540,2.0,2540,0,2006
64,625000.0,4.0,2.75,2920,2.0,2920,0,2012
65,553000.0,2.0,1.0,900,1.0,900,0,1944
66,379880.0,3.0,2.5,1650,1.0,1130,520,1986
67,310000.0,3.0,1.0,1010,1.0,1010,0,1973
68,775000.0,2.0,2.5,2680,1.0,2680,0,2004
69,365000.0,3.0,2.5,2200,1.0,1570,630,1988
70,331950.0,4.0,2.5,2530,2.0,2010,520,1990
71,783500.0,3.0,2.5,2850,2.0,1990,860,1980
72,628000.0,4.0,2.0,2280,1.0,1140,1140,1900
73,560000.0,3.0,2.5,1900,2.0,1900,0,1987
74,900000.0,3.0,1.0,1330,1.0,1330,0,1928
75,531000.0,2.0,3.0,1270,2.0,1110,160,2000
76,831000.0,4.0,3.0,2170,2.0,1610,560,1982
77,780000.0,4.0,2.5,2730,2.0,2730,0,1996
78,755000.0,4.0,2.5,2120,1.0,1620,500,1960
79,705380.0,3.0,2.5,2490,2.0,2490,0,2003
80,627000.0,4.0,2.25,1990,1.0,1210,780,1973
81,865000.0,4.0,3.0,3690,2.0,3690,0,1998
82,580000.0,2.0,1.0,2540,1.0,1320,1220,1942
83,410000.0,3.0,2.25,1800,1.0,1360,440,1978
84,485000.0,4.0,3.0,2340,1.0,1340,1000,1979
85,400000.0,2.0,1.75,2110,1.0,2110,0,1948
86,549000.0,2.0,1.0,1140,1.0,1140,0,1908
87,620000.0,3.0,1.75,1480,2.5,1480,0,2005
88,405000.0,2.0,3.0,1410,2.0,1140,270,2006
89,232000.0,2.0,1.0,1200,1.0,1200,0,1958
90,800866.0,5.0,2.5,3180,2.0,3180,0,1990
91,650000.0,3.0,1.5,2160,1.0,1400,760,1949
93,770000.0,3.0,2.0,2350,1.5,1810,540,1939
94,524000.0,3.0,1.75,1560,1.0,780,780,1944
95,541125.0,5.0,2.75,2740,1.0,1370,1370,1960
96,670000.0,3.0,2.5,1680,3.0,1680,0,1909
97,384900.0,5.0,2.5,3090,1.0,1750,1340,1968
98,406100.0,3.0,2.25,1410,3.0,1410,0,2005
100,736500.0,4.0,2.5,3180,2.0,3180,0,2000
101,570000.0,3.0,2.25,2010,1.0,1330,680,1975
102,787000.0,3.0,1.75,1330,1.0,1330,0,1961
103,328000.0,4.0,2.5,2370,2.0,2370,0,1998
104,435000.0,5.0,2.0,1840,1.0,1540,300,1942
105,499000.0,4.0,2.5,2910,2.0,2910,0,2006
106,501000.0,4.0,1.0,2070,1.0,1160,910,1963
108,400000.0,2.0,1.0,840,1.0,840,0,1955
109,220000.0,4.0,1.5,1240,1.0,1240,0,1971
110,657100.0,4.0,1.0,1390,1.0,1050,340,1924
111,309950.0,4.0,2.75,2310,2.0,2310,0,2006
112,300000.0,3.0,2.0,1050,1.0,1050,0,1986
113,525888.0,5.0,1.75,2550,1.0,1810,740,1960
114,740000.0,4.0,1.75,2010,1.5,2010,0,1902
115,340000.0,5.0,1.0,1120,1.5,1120,0,1962
116,398750.0,3.0,2.5,2230,2.0,2230,0,1954
117,206000.0,2.0,1.0,810,1.0,810,0,1944
118,1030000.0,5.0,2.75,3190,1.0,1690,1500,1976
119,600000.0,3.0,1.75,1670,1.0,1670,0,1976
120,379950.0,4.0,1.75,1970,1.0,1140,830,1960
121,287000.0,3.0,1.0,1450,1.0,1450,0,1953
123,309950.0,3.0,2.5,1880,2.0,1880,0,1994
124,600000.0,3.0,1.75,1880,1.0,1040,840,1945
125,418000.0,3.0,2.0,1410,1.5,1410,0,1930
126,449250.0,4.0,2.0,1480,1.5,1480,0,1928
127,329950.0,2.0,1.0,1140,1.5,1140,0,1949
128,245000.0,3.0,1.75,1920,1.0,1000,920,1984
129,549000.0,4.0,2.5,2910,2.0,2910,0,2008
130,800000.0,3.0,2.5,3240,2.0,3240,0,1994
131,249950.0,3.0,2.0,1550,1.0,1550,0,1958
132,210000.0,5.0,2.0,2050,1.0,1430,620,1956
134,585000.0,2.0,1.0,1770,1.5,1520,250,1949
135,615000.0,4.0,1.75,2300,1.0,1960,340,1977
136,618500.0,3.0,2.0,1800,1.0,1080,720,1942
137,487585.0,4.0,1.75,2010,1.0,1470,540,1977
138,509900.0,3.0,2.5,1790,2.0,1790,0,2010
139,631625.0,4.0,2.5,2440,2.0,2440,0,2014
140,555000.0,3.0,2.5,1940,2.0,1940,0,2009
141,340000.0,2.0,1.5,1160,2.0,1160,0,2001
142,830000.0,4.0,2.5,3400,2.0,3400,0,2007
143,890000.0,4.0,4.25,4420,2.0,3410,1010,2006
144,366750.0,3.0,3.0,1571,3.0,1571,0,2008
145,415000.0,3.0,2.25,1620,2.5,1540,80,2010
146,416286.0,3.0,2.5,1408,3.0,1408,0,2005
147,478000.0,3.0,2.5,3040,2.0,3040,0,2007
149,419190.0,2.0,2.5,1590,2.0,1590,0,2014
150,712198.0,4.0,2.5,2450,2.0,2450,0,2013
151,397000.0,4.0,2.0,1440,1.0,1200,240,1971
152,450000.0,2.0,2.0,1100,1.5,1100,0,1912
153,353000.0,3.0,1.0,1350,1.0,860,490,1947
154,609000.0,4.0,2.5,2150,2.0,2150,0,1985
155,234000.0,3.0,1.75,1490,1.0,1010,480,1975
156,561000.0,3.0,2.0,2000,2.0,2000,0,1916
157,469000.0,2.0,1.0,1030,1.0,1030,0,1924
158,329350.0,2.0,1.0,720,1.0,720,0,1942
159,488000.0,5.0,2.0,2020,1.5,2020,0,1938
160,279900.0,3.0,1.75,1580,1.0,1100,480,1962
161,606000.0,4.0,2.5,2110,2.0,2110,0,1987
162,312000.0,4.0,2.0,1300,1.0,1300,0,1950
163,650000.0,3.0,1.5,1630,1.0,1160,470,1940
164,1135000.0,4.0,2.75,3370,1.0,1970,1400,1970
165,325000.0,4.0,2.5,1890,1.0,980,910,1980
166,425000.0,4.0,2.0,1520,1.0,1520,0,1967
167,219000.0,2.0,1.0,900,1.0,900,0,1952
168,250000.0,3.0,1.0,1050,1.0,1050,0,1954
169,390000.0,3.0,1.75,1260,1.0,1260,0,1966
171,736000.0,4.0,2.5,2290,2.0,2290,0,1988
172,407000.0,4.0,2.25,2810,1.0,1710,1100,1958
173,272000.0,3.0,2.5,1650,2.0,1650,0,1998
174,362000.0,3.0,2.25,1640,1.0,1140,500,1963
175,535000.0,3.0,2.5,1850,2.0,1850,0,1991
176,284000.0,4.0,2.5,2000,2.0,2000,0,2003
177,367500.0,3.0,1.5,1410,1.0,1410,0,1961
178,379900.0,4.0,1.75,1500,1.0,1000,500,1955
179,520000.0,3.0,2.5,2460,2.0,2460,0,1980
180,175000.0,3.0,1.0,1010,1.0,1010,0,1954
181,460000.0,2.0,2.25,1230,2.0,1020,210,2004
182,345000.0,4.0,2.5,2331,2.0,2331,0,2007
183,455000.0,5.0,2.5,2240,1.0,1340,900,1978
184,610000.0,4.0,3.0,2450,1.0,1580,870,1967
185,563000.0,4.0,3.0,3100,2.0,2400,700,1996
186,612500.0,4.0,2.0,2060,1.0,1030,1030,1949
187,218000.0,3.0,1.75,1850,1.0,1320,530,1979
188,404000.0,4.0,1.75,1840,1.0,960,880,1958
189,860000.0,4.0,2.0,3740,2.0,3740,0,2000
190,136500.0,3.0,1.5,1420,1.0,1420,0,1962
191,313950.0,3.0,1.0,1510,1.0,860,650,1940
192,575000.0,3.0,1.75,2130,1.0,1170,960,1954
193,1225000.0,4.0,2.25,3490,2.0,2280,1210,1928
194,280000.0,3.0,1.75,1630,1.0,1630,0,1971
195,515000.0,3.0,2.5,1790,2.0,1790,0,1989
196,513000.0,4.0,2.5,2000,2.0,2000,0,1996
197,599000.0,4.0,2.25,2260,2.0,1400,860,1977
198,685000.0,4.0,2.5,3030,2.0,3030,0,1999
199,365000.0,3.0,1.5,1310,1.0,1310,0,1950
200,762300.0,4.0,2.5,3880,2.0,3880,0,1987
202,562000.0,5.0,2.25,3040,2.0,3040,0,1984
203,530000.0,5.0,2.5,2910,1.0,1690,1220,1964
204,525000.0,3.0,2.5,2970,1.0,1770,1200,1995
205,484000.0,2.0,1.75,1660,1.0,1160,500,1942
206,725126.0,4.0,2.5,3200,2.0,3200,0,1998
207,360000.0,4.0,2.0,2680,1.0,2680,0,1965
208,387000.0,3.0,1.0,1230,1.0,1230,0,1962
209,483500.0,4.0,2.5,2740,2.0,2740,0,1995
210,655500.0,4.0,3.5,3380,2.0,3380,0,2000
211,345000.0,3.0,1.0,1110,1.0,1110,0,1956
212,533000.0,5.0,2.75,1800,1.5,1400,400,1926
213,385000.0,3.0,1.75,1900,1.0,1280,620,1982
214,675000.0,2.0,1.0,930,1.0,930,0,1951
215,197000.0,3.0,1.75,1690,1.0,1060,630,1976
216,485000.0,3.0,2.0,1420,1.5,1420,0,1905
218,295000.0,3.0,2.25,1980,1.0,1560,420,1974
219,499000.0,2.0,1.75,1170,1.0,740,430,1903
220,1050000.0,3.0,2.5,2200,2.0,1610,590,2008
221,191000.0,3.0,1.5,800,1.0,800,0,1959
222,500000.0,3.0,2.5,1480,3.0,1480,0,2006
224,979000.0,3.0,2.5,2690,3.0,2690,0,2014
225,580000.0,4.0,3.25,3569,2.0,3569,0,2013
226,369950.0,3.0,2.0,1270,3.0,1270,0,2006
228,776000.0,4.0,2.5,3040,2.0,3040,0,2008
229,519950.0,3.0,2.25,1170,3.0,1170,0,2014
230,255000.0,5.0,2.25,2060,1.0,1030,1030,1962
231,495000.0,3.0,1.0,990,1.0,990,0,1943
232,510000.0,4.0,2.5,2430,2.0,2430,0,2003
234,253000.0,3.0,1.75,1250,1.0,1250,0,1994
235,503000.0,3.0,2.75,1540,1.0,1210,330,1980
236,275000.0,3.0,2.5,1600,2.0,1600,0,1993
237,249000.0,3.0,1.0,1110,1.0,1110,0,1952
238,310000.0,3.0,1.75,1840,1.0,1220,620,1974
239,750000.0,3.0,2.75,2520,1.0,1360,1160,1946
240,630000.0,3.0,2.5,2680,2.0,2680,0,1995
242,758000.0,4.0,2.75,2410,1.0,1780,630,1956
243,248500.0,4.0,1.75,1720,1.0,1720,0,1960
244,310000.0,3.0,1.75,2070,1.0,1420,650,1973
245,460000.0,3.0,2.0,1760,2.0,1760,0,1985
246,675000.0,3.0,1.75,1680,1.0,1680,0,1959
247,526000.0,2.0,2.0,1550,1.5,1550,0,1900
248,560000.0,3.0,3.0,4120,2.0,3180,940,1994
249,415000.0,4.0,3.0,1830,2.0,1830,0,1991
250,246000.0,3.0,1.0,1400,1.0,1400,0,1944
251,314500.0,3.0,1.75,1870,1.0,1870,0,1957
253,420000.0,2.0,1.5,1040,1.5,1040,0,1904
254,535000.0,3.0,1.75,2720,1.5,2720,0,1988
255,350000.0,3.0,1.0,1010,1.0,1010,0,1981
256,515000.0,3.0,1.75,1580,1.0,1210,370,1967
257,749950.0,4.0,2.75,2600,2.0,1960,640,1949
258,230000.0,3.0,2.5,1920,2.0,1920,0,1988
259,568000.0,3.0,2.0,2350,1.5,1780,570,1929
260,250000.0,1.0,1.0,1100,1.0,820,280,1947
261,581000.0,4.0,2.0,2510,1.0,1280,1230,1961
262,651000.0,3.0,2.5,3240,2.0,3240,0,1991
263,600000.0,3.0,2.5,2460,1.0,1860,600,1977
264,500000.0,2.0,1.0,1010,1.5,1010,0,1906
265,475000.0,2.0,1.0,820,1.0,820,0,1921
266,352000.0,5.0,2.5,2420,1.0,1620,800,1978
267,420000.0,3.0,2.25,1770,2.0,1770,0,1977
268,428000.0,2.0,2.0,1350,1.0,1350,0,2003
269,599000.0,3.0,1.75,1960,1.0,1090,870,1920
270,492000.0,4.0,2.5,3305,1.5,2245,1060,1922
271,630000.0,2.0,2.25,2550,1.0,1720,830,2011
272,900000.0,5.0,3.75,4130,2.0,3170,960,1985
273,1110000.0,4.0,1.5,2310,1.0,1890,420,1950
274,575000.0,4.0,2.0,1650,1.0,1650,0,1955
275,705000.0,4.0,2.5,2650,1.5,1520,1130,1905
276,940000.0,4.0,2.25,1890,1.0,1470,420,1963
277,313000.0,3.0,1.75,2190,1.0,2190,0,1967
278,618080.0,3.0,2.5,2030,2.0,2030,0,1988
279,640000.0,3.0,3.0,2270,2.0,2130,140,2002
280,485000.0,3.0,2.0,1610,1.0,1010,600,1917
281,300000.0,2.0,1.0,760,1.0,760,0,1913
282,379500.0,2.0,1.0,1640,1.0,840,800,1978
283,339950.0,3.0,2.25,1630,2.0,1630,0,1985
285,1340000.0,3.0,3.0,2960,2.0,2440,520,1937
286,500000.0,3.0,2.5,1940,1.0,1940,0,1987
287,239900.0,3.0,2.0,1410,1.0,1410,0,1985
288,314950.0,3.0,1.0,1040,1.0,1040,0,1968
289,361280.0,2.0,1.0,820,1.0,820,0,1944
290,100000.0,2.0,1.0,910,1.0,910,0,1956
292,480500.0,4.0,2.5,2180,1.0,2180,0,1968
293,280000.0,3.0,2.5,1600,2.0,1600,0,2000
294,440000.0,3.0,1.75,1500,1.0,1060,440,1947
295,530000.0,3.0,1.0,1340,1.0,1080,260,1910
296,560000.0,3.0,2.0,1860,1.0,1860,0,1985
297,775000.0,3.0,2.0,2540,1.5,1600,940,1905
298,160000.0,2.0,1.0,1040,1.0,1040,0,1912
299,209950.0,3.0,1.5,1380,1.0,1380,0,1960
300,226500.0,3.0,1.75,1640,1.0,1130,510,1988
301,380000.0,5.0,1.75,3000,1.0,1500,1500,1958
302,409500.0,4.0,2.75,2140,1.0,1320,820,1968
303,690000.0,3.0,2.0,1760,1.0,980,780,1942
304,405000.0,3.0,2.25,1660,1.0,1660,0,1961
305,375000.0,3.0,2.5,1830,2.0,1830,0,1990
306,794154.0,4.0,2.0,2210,1.0,1210,1000,1954
307,185000.0,4.0,1.0,1490,1.0,1490,0,1969
308,245000.0,3.0,1.5,1260,2.0,1040,220,2005
310,1040000.0,4.0,3.5,3900,2.0,3900,0,2006
311,425000.0,2.0,2.5,1150,3.0,1150,0,2008
312,495000.0,4.0,2.75,2656,2.0,2656,0,2014
313,365000.0,5.0,2.75,2410,1.0,1410,1000,2008
314,417250.0,3.0,2.25,1606,3.0,1606,0,2009
315,339950.0,2.0,1.0,820,3.0,820,0,2006
316,615000.0,2.0,1.0,1540,1.0,820,720,1946
317,403000.0,3.0,2.75,2090,2.0,2090,0,2012
318,980000.0,5.0,2.5,3160,1.0,1780,1380,1971
319,258000.0,4.0,1.75,1730,1.0,1230,500,1977
320,533000.0,3.0,1.0,1670,1.0,1170,500,1967
321,537500.0,4.0,2.5,2550,2.0,2550,0,2005
322,830000.0,5.0,3.0,3040,1.0,1970,1070,1968
323,712000.0,3.0,1.0,1250,1.5,1150,100,1900
324,262000.0,4.0,2.5,2020,2.0,2020,0,2002
325,753888.0,4.0,2.5,2660,2.0,2660,0,2003
326,134000.0,2.0,1.5,980,2.0,980,0,1922
327,402000.0,3.0,2.5,1960,1.0,1290,670,1977
328,205000.0,2.0,1.0,720,1.0,720,0,1955
329,553650.0,2.0,2.5,1360,2.0,1050,310,1997
330,559950.0,2.0,2.0,1870,1.0,1870,0,2006
331,260000.0,4.0,1.5,2130,1.0,1100,1030,1962
332,270000.0,4.0,2.5,1810,2.0,1810,0,1994
333,295000.0,2.0,1.75,2200,1.0,1100,1100,1973
334,719000.0,3.0,2.5,1690,1.5,1690,0,1928
335,266000.0,3.0,2.5,1940,1.0,1460,480,1989
336,325900.0,4.0,2.5,2320,2.0,2320,0,2004
337,647500.0,4.0,1.75,2060,1.0,1160,900,1947
338,1039000.0,4.0,1.0,3410,2.0,2190,1220,1910
339,569000.0,4.0,2.25,2250,2.0,2250,0,1980
340,246000.0,3.0,1.75,1390,1.0,1390,0,1975
341,515000.0,2.0,1.0,1060,1.0,1060,0,1926
342,207000.0,3.0,1.0,1490,1.0,1490,0,1954
343,780000.0,4.0,1.75,2480,1.0,1390,1090,1950
344,489990.0,5.0,2.25,2440,1.5,2440,0,1975
345,335000.0,3.0,1.5,2240,1.5,1480,760,1980
346,295000.0,3.0,2.5,1920,2.0,1920,0,1993
347,385000.0,3.0,1.75,1890,1.0,1230,660,1944
348,350000.0,4.0,1.75,2250,1.0,2150,100,1940
349,235000.0,2.0,1.0,1270,1.0,650,620,1923
350,358000.0,2.0,1.5,960,2.0,960,0,1993
351,716500.0,4.0,2.5,3290,2.0,3290,0,2002
352,228000.0,4.0,1.75,2000,1.0,1100,900,1965
353,405000.0,2.0,1.0,1020,1.0,1020,0,1948
354,538000.0,4.0,1.75,1840,1.0,1220,620,1967
355,530000.0,3.0,1.75,1980,1.0,1980,0,1973
357,636000.0,2.0,1.75,1230,1.5,1230,0,1925
358,535000.0,4.0,2.5,2280,2.0,2280,0,2004
360,868500.0,3.0,2.5,2920,3.0,2920,0,2008
361,530000.0,4.0,2.75,2280,1.5,1540,740,1930
362,450000.0,3.0,2.0,1510,1.0,1510,0,1954
363,230000.0,3.0,1.75,950,1.0,790,160,1939
364,229000.0,3.0,2.5,1190,2.0,1190,0,2002
365,437000.0,3.0,1.75,1310,1.0,1310,0,1976
366,1307000.0,5.0,3.25,2800,1.5,1910,890,1932
367,595000.0,3.0,2.5,1750,2.0,1750,0,1991
368,660000.0,3.0,1.75,1320,1.5,1320,0,1918
369,347500.0,4.0,2.5,2460,2.0,2460,0,1989
370,297950.0,3.0,2.0,1240,1.0,1240,0,1967
371,245000.0,3.0,1.5,1260,1.0,1260,0,1955
373,1250000.0,4.0,3.25,3820,2.0,3310,510,1990
374,413450.0,3.0,2.5,1540,3.0,1470,70,2008
375,330000.0,2.0,2.0,1550,1.5,1550,0,1972
376,424500.0,3.0,1.75,1460,1.0,1460,0,1979
377,230000.0,3.0,1.0,1390,1.0,1390,0,1960
378,930000.0,3.0,3.25,2640,2.0,1840,800,1912
379,349000.0,3.0,1.75,1590,1.0,1590,0,1988
380,835000.0,4.0,2.0,1910,1.5,1910,0,1941
381,988500.0,3.0,2.75,2015,2.0,2015,0,2007
382,500000.0,3.0,1.75,1410,3.0,1410,0,2012
383,499000.0,2.0,1.5,1110,2.0,930,180,2005
384,321950.0,2.0,1.25,860,2.0,860,0,2007
385,494000.0,3.0,2.5,2310,2.0,2310,0,2011
386,441750.0,2.0,1.5,1020,3.0,1020,0,2008
387,438000.0,2.0,1.0,980,2.0,980,0,2010
389,352000.0,3.0,2.25,1640,1.0,1640,0,1972
390,839900.0,4.0,3.5,3810,1.0,2560,1250,2013
391,765000.0,4.0,2.75,2790,2.0,2790,0,1996
392,460000.0,4.0,1.75,1750,1.5,1050,700,1926
393,224500.0,4.0,1.0,1430,1.5,1430,0,1983
394,254000.0,3.0,2.5,1850,2.0,1850,0,2003
395,255000.0,2.0,1.0,960,1.0,960,0,1984
396,610000.0,3.0,3.0,2480,1.0,1620,860,1976
397,920000.0,4.0,3.0,3750,2.0,3750,0,1976
398,402500.0,4.0,2.5,2600,2.0,2600,0,1988
399,280950.0,3.0,1.75,1390,1.0,840,550,1912
400,604000.0,4.0,2.5,2260,2.0,2260,0,1989
401,565000.0,4.0,2.25,2470,2.0,2470,0,1984
402,255000.0,2.0,1.0,810,1.0,810,0,1928
403,445000.0,4.0,2.0,1650,1.0,1000,650,1959
405,195000.0,2.0,1.0,720,1.0,720,0,1950
406,275000.0,3.0,1.5,1390,1.0,1390,0,1922
407,387000.0,3.0,2.25,1445,2.0,1300,145,2003
408,490000.0,2.0,1.0,1840,1.5,1130,710,1910
409,505000.0,3.0,2.5,2100,2.0,2100,0,1999
410,303500.0,3.0,1.5,1060,1.0,1060,0,1973
411,270000.0,3.0,1.5,1500,1.0,1500,0,1953
412,323000.0,4.0,2.75,1970,1.0,1170,800,1977
413,382000.0,3.0,3.25,1410,3.0,1410,0,2005
415,280000.0,4.0,2.0,2190,1.0,1180,1010,1977
416,260000.0,3.0,2.0,1920,1.0,1510,410,1969
417,201500.0,3.0,1.0,1160,1.0,1160,0,1959
419,536500.0,4.0,1.75,2000,1.5,1450,550,1926
420,248000.0,4.0,3.0,2163,2.0,2163,0,2006
421,532000.0,5.0,3.0,3480,1.0,2340,1140,1976
422,580000.0,4.0,2.5,2840,2.0,2840,0,1998
423,463000.0,2.0,1.0,1150,1.0,1150,0,1905
424,742500.0,4.0,2.75,3100,2.0,2000,1100,1919
425,260000.0,3.0,2.5,1420,1.0,1020,400,1963
426,590000.0,4.0,2.25,2430,1.0,2430,0,1993
427,312000.0,4.0,2.25,1930,1.0,1430,500,1984
428,566000.0,3.0,2.25,1660,1.0,1370,290,1980
429,511555.0,3.0,2.0,1400,1.0,1400,0,1963
430,583000.0,4.0,2.5,2660,2.0,2660,0,2001
431,290000.0,4.0,2.5,2000,1.0,1200,800,1968
432,311100.0,4.0,2.25,2130,1.0,1380,750,1977
433,325000.0,3.0,2.25,1352,3.0,1352,0,2007
434,491300.0,3.0,1.75,1750,1.0,1300,450,1987
435,315000.0,5.0,1.75,2320,1.0,1160,1160,1956
436,360000.0,2.0,1.0,1420,1.0,1180,240,1956
437,330000.0,4.0,2.5,1940,2.0,1940,0,2003
438,481450.0,3.0,2.0,1410,1.0,1410,0,1940
439,234950.0,3.0,1.0,1360,1.0,1360,0,1977
440,251000.0,3.0,1.75,1220,1.0,1220,0,1962
441,782000.0,4.0,2.5,2830,2.0,1980,850,1979
442,833000.0,4.0,2.75,3780,2.0,3780,0,1999
443,542500.0,4.0,2.5,2330,2.0,2330,0,1978
444,851000.0,3.0,2.5,3560,2.0,3560,0,1987
445,325000.0,4.0,1.5,1470,1.0,1470,0,1976
446,415000.0,4.0,2.25,3060,2.0,3060,0,1992
447,252500.0,3.0,1.0,1030,1.0,880,150,1947
448,465000.0,4.0,2.5,1930,1.0,1930,0,1968
449,336900.0,3.0,1.75,1780,1.0,1780,0,1979
450,225000.0,3.0,2.5,2000,2.0,2000,0,1992
451,270000.0,3.0,2.0,1690,1.0,1690,0,1969
453,536000.0,3.0,1.75,1300,1.5,1300,0,1925
454,585000.0,4.0,3.25,2400,2.0,2400,0,1982
455,445000.0,2.0,2.0,1150,1.0,860,290,1940
456,320000.0,4.0,2.25,2310,2.0,2310,0,1980
457,769900.0,4.0,3.5,2730,2.0,2400,330,2006
458,557000.0,4.0,2.5,2840,2.0,2840,0,2012
459,212000.0,2.0,1.5,1020,2.0,1020,0,2004
460,376000.0,3.0,2.0,1340,3.0,1340,0,2008
461,800000.0,4.0,3.25,3540,2.0,3540,0,2007
463,324000.0,3.0,2.25,998,2.0,798,200,2007
464,549900.0,5.0,2.75,3060,1.0,1600,1460,1979
465,320000.0,3.0,2.5,2130,2.0,2130,0,2003
466,875000.0,4.0,2.0,2520,1.0,1400,1120,1921
467,265000.0,4.0,1.0,1940,1.0,1080,860,1962
468,394950.0,3.0,2.5,1350,3.0,1270,80,2006
469,842500.0,4.0,2.5,2160,2.5,2160,0,1902
470,368000.0,3.0,2.5,1370,2.0,1010,360,2007
472,885000.0,4.0,2.5,2830,2.0,2830,0,1995
473,453246.0,3.0,2.5,2010,2.0,1390,620,2014
474,927000.0,4.0,2.75,3300,2.0,3300,0,1953
475,490000.0,2.0,2.5,1230,2.0,870,360,2004
476,341000.0,3.0,1.5,1720,1.5,1720,0,1952
477,235000.0,1.0,1.0,810,1.0,810,0,1941
478,1200000.0,3.0,1.75,1560,1.5,1560,0,1928
479,560000.0,3.0,2.0,2560,1.0,2560,0,1986
481,255000.0,2.0,1.0,1220,1.0,770,450,1910
483,876650.0,3.0,3.25,2170,1.5,1650,520,1928
484,540000.0,4.0,2.25,2540,1.0,1450,1090,1990
485,350000.0,2.0,1.0,910,1.5,910,0,1906
486,750000.0,4.0,2.5,2980,2.0,2890,90,2000
487,582000.0,4.0,1.75,2120,1.0,1190,930,1951
488,1315000.0,4.0,3.5,3460,2.0,2560,900,2004
489,372500.0,5.0,3.0,2480,1.0,1300,1180,2004
490,410000.0,3.0,2.25,2200,2.0,2200,0,1987
491,360000.0,4.0,2.0,1730,1.0,1010,720,1943
492,1015000.0,3.0,2.5,2920,1.0,1800,1120,1954
493,225000.0,3.0,1.0,990,1.0,990,0,1966
494,647000.0,4.0,2.5,3040,2.0,3040,0,1999
496,185000.0,3.0,1.5,1370,1.0,1370,0,1961
497,335000.0,3.0,2.5,1940,2.0,1940,0,2004
498,210000.0,3.0,2.5,1040,2.0,720,320,2004
499,522000.0,4.0,2.25,1800,1.0,1360,440,1980
500,770000.0,3.0,1.75,1720,1.0,1720,0,1954
501,499950.0,3.0,1.0,980,1.0,760,220,1941
502,751000.0,4.0,2.5,3110,2.0,3110,0,2004
503,330000.0,5.0,3.0,2100,1.0,1250,850,2013
504,465000.0,3.0,1.5,2020,1.0,1190,830,1956
505,850000.0,4.0,1.75,2350,1.0,2350,0,1961
506,947500.0,4.0,2.25,3290,1.5,3290,0,1968
507,302000.0,5.0,2.25,2180,2.0,2180,0,1986
508,500000.0,2.0,2.25,1290,3.0,1290,0,2007
509,201000.0,3.0,1.0,1460,1.0,1460,0,1969
510,265000.0,2.0,1.0,1290,2.0,1290,0,2008
511,870300.0,4.0,2.5,2350,1.5,1690,660,1910
512,339000.0,3.0,1.0,1080,1.0,1080,0,1955
513,690000.0,4.0,2.5,2670,2.0,2670,0,1989
514,788000.0,4.0,3.25,3680,2.0,2840,840,2003
515,315275.0,3.0,1.75,1440,1.0,960,480,1951
516,505000.0,4.0,1.75,1940,1.0,1030,910,1922
517,368000.0,3.0,1.0,1280,1.0,1280,0,1968
518,947500.0,3.0,2.75,2980,1.5,2180,800,1917
519,156000.0,3.0,1.0,970,1.0,970,0,1959
520,610000.0,4.0,3.0,2110,1.5,1640,470,1930
521,420000.0,2.0,2.5,1480,3.0,1480,0,2009
522,192000.0,2.0,1.0,700,1.0,700,0,1953
523,910000.0,3.0,2.0,2700,1.0,1350,1350,1962
524,1300000.0,4.0,3.25,2330,2.0,2330,0,1918
526,840000.0,4.0,2.75,2600,1.5,1620,980,1936
527,300000.0,2.0,1.75,1360,1.0,860,500,1975
528,505000.0,4.0,2.5,2780,1.0,1590,1190,1978
529,110000.0,3.0,1.0,1250,1.0,1250,0,1945
530,746000.0,3.0,2.5,2620,2.0,2620,0,1992
531,211000.0,3.0,1.5,1350,1.0,1350,0,1941
532,675000.0,4.0,3.0,2400,1.0,1200,1200,1964
533,734200.0,4.0,2.5,2760,1.5,1680,1080,1928
534,1225000.0,4.0,2.25,3070,1.0,1870,1200,1976
535,615000.0,2.0,1.75,2040,1.5,2040,0,1919
536,630000.0,4.0,2.0,1770,2.0,1770,0,1911
537,1264000.0,4.0,3.75,3490,2.0,3490,0,2012
538,301500.0,2.0,1.5,830,2.0,830,0,2005
539,369000.0,2.0,2.5,980,2.0,670,310,2009
540,635000.0,3.0,2.5,1570,3.0,1570,0,2010
541,1033888.0,4.0,3.25,3270,2.0,3110,160,2014
542,383000.0,4.0,2.5,2160,2.0,2160,0,2010
543,1050000.0,4.0,3.75,3280,2.0,2320,960,2008
544,455000.0,4.0,2.5,3360,2.0,3360,0,2001
545,819900.0,5.0,2.75,3150,2.0,3150,0,2013
546,625000.0,3.0,3.5,1810,2.0,1440,370,2009
547,651000.0,4.0,2.5,2740,2.0,2740,0,1993
549,757000.0,3.0,3.25,3190,2.0,3190,0,2007
550,460000.0,3.0,2.25,2350,1.0,1390,960,1977
551,267345.0,4.0,2.25,2510,1.0,1610,900,1972
552,530000.0,2.0,2.0,1680,1.0,1680,0,2006
553,449500.0,3.0,2.0,1770,1.0,960,810,1954
554,289000.0,3.0,1.0,1090,1.0,1090,0,1981
555,373000.0,5.0,2.5,3001,2.0,3001,0,2006
556,525000.0,5.0,3.0,2450,2.0,2450,0,1994
557,777000.0,3.0,3.25,3610,2.0,2440,1170,2003
558,550000.0,4.0,2.0,2250,1.0,1200,1050,1956
559,523000.0,3.0,1.5,1240,1.0,1240,0,1957
560,628000.0,4.0,2.0,2260,1.0,1430,830,1958
561,581000.0,4.0,1.75,2090,1.0,1070,1020,1963
562,245000.0,5.0,1.75,2020,1.0,1220,800,1962
563,415000.0,3.0,1.75,1960,1.0,980,980,1911
565,225000.0,3.0,1.5,1250,1.0,1250,0,1967
566,287000.0,3.0,2.25,1490,1.0,1170,320,1987
568,239950.0,3.0,1.0,1900,1.5,1900,0,1942
569,591000.0,3.0,1.75,1680,1.0,870,810,1922
570,700000.0,3.0,2.5,2030,2.0,2030,0,1975
571,475000.0,4.0,2.5,3740,1.0,2260,1480,2004
572,575000.0,3.0,1.75,1580,1.0,1180,400,1951
573,771000.0,3.0,2.25,1780,1.5,1390,390,1927
574,155000.0,2.0,1.0,910,1.0,910,0,1943
576,645000.0,3.0,2.5,1740,2.0,1740,0,1975
579,350000.0,3.0,2.5,2010,2.0,2010,0,1977
580,591000.0,4.0,2.25,2710,2.0,2710,0,1977
582,717000.0,3.0,1.5,1310,1.0,1090,220,1956
583,225000.0,4.0,1.5,1950,1.5,1950,0,1939
584,225000.0,3.0,1.0,1040,1.0,1040,0,1947
585,345000.0,3.0,1.75,1090,1.0,1090,0,1968
586,230000.0,2.0,0.75,650,1.0,650,0,1931
587,385000.0,3.0,2.0,1480,1.0,740,740,1943
588,90000.0,2.0,1.0,790,1.0,790,0,1973
589,860000.0,4.0,2.5,3560,1.0,2290,1270,1986
590,675000.0,4.0,2.5,3000,2.0,3000,0,2006
591,975000.0,4.0,2.5,3490,2.0,3490,0,2000
592,780000.0,3.0,1.75,2340,1.0,2340,0,1967
593,370000.0,3.0,1.75,1650,1.0,1060,590,1951
594,665000.0,3.0,2.0,1940,1.5,1150,790,1944
595,675000.0,5.0,3.0,3410,1.0,1870,1540,1968
596,620000.0,3.0,1.0,1710,1.5,1710,0,1909
597,1105000.0,4.0,1.5,2740,2.0,1930,810,1905
598,450000.0,3.0,2.75,1250,2.0,1040,210,2010
599,450000.0,3.0,2.25,2450,1.0,2450,0,1978
600,530000.0,3.0,1.75,1690,1.0,1690,0,1958
601,635000.0,4.0,1.75,1950,1.0,1370,580,1969
602,580000.0,5.0,2.0,2290,1.0,1190,1100,1964
604,285000.0,3.0,1.0,1090,1.0,1090,0,1973
605,375000.0,3.0,1.0,1190,1.0,1190,0,1953
607,560000.0,3.0,1.0,1440,2.0,1440,0,1910
608,405000.0,4.0,1.75,2180,1.0,1090,1090,1956
609,413000.0,4.0,1.0,1410,1.0,810,600,1925
610,287600.0,3.0,2.5,1950,2.0,1950,0,1990
612,225000.0,3.0,1.0,1660,1.0,1100,560,1963
613,319000.0,3.0,1.0,1390,1.0,1390,0,1968
614,322500.0,3.0,2.0,1350,1.0,1350,0,1989
615,570000.0,3.0,2.0,1530,1.0,1530,0,1937
616,465000.0,3.0,1.5,1270,1.0,1270,0,1950
617,435000.0,4.0,2.25,2140,2.0,2140,0,2002
618,502000.0,4.0,2.5,2040,2.0,2040,0,2012
619,525000.0,3.0,3.5,2876,2.0,2360,516,2007
620,525000.0,3.0,2.5,1580,2.0,1010,570,2008
621,660000.0,4.0,3.5,3400,2.0,3400,0,2012
622,870000.0,4.0,2.5,3520,2.5,2650,870,2006
623,650000.0,4.0,2.5,2210,2.0,2210,0,2013
624,505000.0,4.0,2.5,2790,2.0,2790,0,2009
625,330000.0,3.0,2.5,1450,1.0,840,610,2007
626,385000.0,4.0,1.75,1620,1.0,860,760,1947
627,306000.0,3.0,1.5,1220,3.0,1220,0,2007
628,546000.0,3.0,1.75,2000,1.0,1110,890,1921
629,925000.0,4.0,2.5,2190,2.5,2190,0,1958
630,542000.0,4.0,1.75,1900,1.0,950,950,1955
631,800000.0,3.0,1.0,1700,1.5,1700,0,1906
632,620000.0,5.0,2.5,2540,2.0,1760,780,1929
633,175000.0,2.0,1.0,1170,1.0,1170,0,1911
635,345000.0,3.0,2.25,2120,2.0,2120,0,1984
636,510000.0,3.0,1.75,2170,1.0,1450,720,1986
637,530000.0,4.0,2.75,2450,1.0,2450,0,1974
638,155000.0,2.0,1.0,700,1.0,700,0,1952
639,266000.0,3.0,2.5,1780,1.0,1400,380,1986
640,257200.0,3.0,2.0,1850,1.0,1150,700,1952
641,265000.0,3.0,2.0,1570,1.0,1570,0,1998
642,372220.0,3.0,1.0,1290,1.0,980,310,1951
643,337500.0,5.0,2.0,1700,1.0,1000,700,1956
644,582500.0,2.0,1.5,1159,1.0,1159,0,1948
645,489200.0,3.0,2.75,1850,1.5,1850,0,1965
646,405100.0,2.0,1.0,840,1.0,840,0,1947
647,372977.0,3.0,2.5,1690,2.0,1150,540,2014
648,310000.0,3.0,1.0,1050,1.0,1050,0,1953
649,538000.0,3.0,1.75,1400,1.5,1100,300,1904
651,317000.0,3.0,2.5,1840,2.0,1840,0,2012
652,702500.0,3.0,1.5,2360,2.0,1930,430,1926
653,565000.0,4.0,2.5,2240,2.0,2240,0,1989
654,723000.0,4.0,2.5,2700,2.0,2700,0,2004
655,766950.0,3.0,2.5,3030,1.5,3030,0,1992
656,682000.0,3.0,1.75,1830,1.5,1830,0,1903
657,325000.0,3.0,2.5,2220,2.0,2220,0,1990
658,543000.0,3.0,2.5,2090,1.0,1360,730,1962
659,525000.0,3.0,1.75,1600,1.5,1600,0,1924
660,364000.0,4.0,1.75,2010,1.0,1340,670,1957
661,394475.0,2.0,1.0,830,1.0,830,0,1955
662,316000.0,4.0,2.5,2010,2.0,2010,0,1995
663,339950.0,3.0,1.0,1050,1.5,1050,0,1906
664,486000.0,4.0,2.5,2150,1.0,1420,730,1978
665,160000.0,3.0,1.0,860,1.0,860,0,1963
666,930000.0,3.0,2.5,3100,1.0,3100,0,1954
667,139000.0,3.0,1.0,1100,1.0,1100,0,1978
668,562000.0,3.0,1.5,1830,1.0,1830,0,1957
669,299000.0,2.0,1.75,1250,1.0,1250,0,1950
670,511000.0,3.0,2.5,1820,2.0,1820,0,2005
671,499000.0,3.0,2.0,2090,1.5,2090,0,1959
672,356000.0,3.0,3.5,2100,2.0,2100,0,1980
673,470000.0,4.0,2.5,2310,2.0,2310,0,1991
674,715000.0,4.0,2.25,2060,1.0,1360,700,1941
676,458000.0,3.0,1.0,1660,1.0,1060,600,1940
678,305495.0,3.0,1.75,2110,2.0,2110,0,1966
679,543000.0,2.0,2.0,2370,1.5,1600,770,1992
680,340000.0,3.0,2.25,1970,2.0,1970,0,1997
681,633100.0,4.0,2.5,2470,2.0,2470,0,1993
682,310000.0,3.0,1.0,1480,1.0,1480,0,1952
683,349950.0,5.0,3.0,2257,1.0,1363,894,2005
684,267800.0,2.0,1.0,700,1.0,700,0,1949
685,234000.0,4.0,2.0,1630,1.0,1050,580,1975
686,740000.0,4.0,2.5,3430,2.0,3430,0,2000
687,607500.0,5.0,1.75,2220,1.5,1420,800,1923
688,223000.0,3.0,1.75,1340,1.0,1340,0,1973
689,400000.0,2.0,1.0,980,1.0,860,120,1918
690,802000.0,3.0,2.5,2580,2.0,2580,0,1986
691,253000.0,4.0,2.5,2230,2.0,2230,0,2006
692,1058000.0,4.0,2.0,2290,1.0,2290,0,1955
693,300000.0,3.0,1.0,1260,1.0,1260,0,1946
694,625000.0,4.0,2.75,1680,1.0,1680,0,1966
695,707000.0,4.0,3.25,3200,2.0,3200,0,2004
696,950000.0,4.0,2.5,3320,2.0,3320,0,1995
697,420000.0,4.0,2.5,3040,2.0,3040,0,1999
698,498000.0,4.0,2.75,2270,1.0,1290,980,1973
699,450000.0,3.0,2.5,2910,2.0,2910,0,1989
700,955000.0,5.0,2.25,2510,2.0,2510,0,1972
701,215000.0,2.0,1.0,1240,1.0,1240,0,1967
702,437000.0,3.0,2.75,2580,2.0,2580,0,2008
703,773000.0,3.0,2.75,2470,2.0,2470,0,2007
705,256883.0,3.0,2.5,1690,2.0,1690,0,2003
706,592500.0,4.0,2.5,2240,1.0,2240,0,1983
707,252350.0,3.0,2.0,1650,1.0,1160,490,1979
708,370000.0,4.0,2.5,2710,2.0,2710,0,1998
709,465750.0,3.0,1.5,1260,1.0,1260,0,1959
710,185000.0,3.0,1.0,1150,1.0,1150,0,1932
711,582800.0,4.0,2.75,2550,1.0,1440,1110,1986
712,245000.0,3.0,1.75,1490,1.0,1490,0,1990
713,302000.0,4.0,1.75,2020,1.0,1010,1010,1963
714,451555.0,2.0,1.0,1320,1.0,1320,0,1912
715,250000.0,3.0,1.0,1230,1.0,1230,0,1957
716,255000.0,4.0,2.5,2070,2.0,2070,0,1989
717,840000.0,4.0,1.75,2930,1.0,1670,1260,1947
718,190000.0,3.0,1.0,1090,1.0,1090,0,1967
719,349950.0,3.0,1.0,1400,1.0,1400,0,1957
720,613000.0,4.0,2.0,1550,1.5,1550,0,1909
721,300000.0,3.0,1.0,1220,1.0,1220,0,1955
722,455000.0,3.0,2.5,1870,1.0,1470,400,1980
723,335000.0,3.0,2.25,2150,2.0,2150,0,1991
724,197500.0,3.0,1.0,980,1.5,980,0,1903
725,412500.0,3.0,1.5,1490,1.0,1490,0,1963
726,395300.0,3.0,1.5,1120,1.0,1120,0,1955
727,342400.0,3.0,2.25,1180,2.0,1180,0,1986
728,749400.0,4.0,2.5,3240,2.0,3240,0,1985
729,316500.0,4.0,2.5,2150,2.0,2150,0,1991
730,390000.0,3.0,2.5,2240,2.0,2240,0,1996
731,225000.0,3.0,2.0,1400,1.0,1150,250,1979
732,550000.0,3.0,2.25,1980,1.0,1980,0,1980
733,280000.0,3.0,1.0,1330,1.5,1330,0,1959
734,1255000.0,4.0,2.5,3200,2.0,3200,0,2006
735,575000.0,2.0,1.0,1490,1.0,1090,400,1946
736,1000000.0,5.0,4.25,3920,2.0,2900,1020,1990
737,585000.0,5.0,1.75,2000,2.0,2000,0,1921
738,620000.0,4.0,2.5,2680,2.0,2680,0,1989
739,204700.0,4.0,2.0,1670,1.0,1670,0,1967
740,695000.0,4.0,3.0,3150,2.0,3150,0,2001
741,689900.0,4.0,3.25,2740,2.0,2060,680,2003
742,375000.0,4.0,1.75,1890,1.0,1250,640,1960
744,215000.0,3.0,1.0,1160,1.0,1160,0,1969
746,790000.0,3.0,1.75,1790,1.0,1350,440,1940
747,350000.0,3.0,1.75,1680,1.0,1070,610,1940
749,263000.0,3.0,2.25,1590,2.0,1590,0,1991
750,400000.0,3.0,1.0,1630,1.0,1630,0,1953
751,525000.0,3.0,2.5,2700,2.0,2700,0,1991
752,349950.0,3.0,2.5,1700,2.0,1700,0,1994
754,744000.0,4.0,3.0,1980,2.5,1980,0,1941
755,312500.0,2.0,1.0,880,1.0,880,0,1919
756,240000.0,3.0,2.0,1400,1.0,700,700,1948
757,495000.0,4.0,2.0,2050,1.5,1210,840,1941
758,580050.0,3.0,2.5,2360,2.0,2360,0,1996
759,640000.0,4.0,2.0,2560,1.0,1890,670,1947
760,417000.0,3.0,1.5,1340,1.0,1340,0,1956
761,174950.0,3.0,1.0,1060,1.0,1060,0,1970
762,295000.0,3.0,1.5,850,1.0,850,0,1986
763,423000.0,4.0,1.75,1880,1.0,1010,870,1976
764,839000.0,3.0,1.0,1230,1.0,1230,0,1955
765,343000.0,4.0,1.75,2290,1.0,1340,950,1960
766,467000.0,3.0,1.0,1660,1.0,1000,660,1946
767,512500.0,3.0,2.5,1840,2.0,1840,0,1997
768,575000.0,4.0,2.5,3020,1.0,1600,1420,1979
769,465000.0,3.0,1.75,1410,1.0,1410,0,1924
770,270000.0,3.0,1.0,1010,1.0,1010,0,1969
771,340000.0,3.0,1.75,1960,1.0,980,980,1948
772,765000.0,5.0,3.75,3580,2.0,3190,390,1999
773,497000.0,4.0,2.5,2240,2.0,2240,0,1995
774,803100.0,4.0,2.5,3310,2.0,3310,0,2004
775,344000.0,3.0,2.5,1232,3.0,1232,0,2007
776,828950.0,4.0,3.5,3930,2.0,2820,1110,2013
777,386380.0,3.0,2.5,1720,2.0,1720,0,2010
778,312000.0,3.0,2.25,1490,2.0,1220,270,2009
779,720000.0,3.0,2.5,3150,2.0,3150,0,2007
780,914500.0,4.0,2.5,3950,3.0,3950,0,2013
781,819995.0,5.0,2.75,3030,2.0,3030,0,2013
782,252700.0,2.0,1.5,1070,1.0,1070,0,1985
783,437500.0,3.0,2.5,2320,2.0,2320,0,1992
784,350000.0,1.0,1.0,700,1.0,700,0,1942
785,619000.0,3.0,2.5,2720,2.0,2720,0,2005
786,408200.0,3.0,2.5,1800,2.0,1800,0,1990
787,451000.0,3.0,1.75,1560,1.5,1000,560,1926
788,317000.0,3.0,2.0,1760,1.0,1060,700,1977
789,799000.0,4.0,3.25,3120,2.0,2370,750,2005
790,720000.0,2.0,1.0,2020,1.0,1700,320,1947
791,490000.0,3.0,2.0,1450,1.5,1450,0,1900
792,239900.0,4.0,2.25,1860,1.0,1120,740,1979
793,446000.0,4.0,2.25,2270,1.0,1290,980,1977
794,275000.0,3.0,2.5,1480,2.0,1480,0,1987
795,239950.0,5.0,1.0,1460,2.0,1460,0,1941
796,248000.0,4.0,3.5,1850,2.0,1130,720,1986
797,619500.0,3.0,2.5,2170,2.0,2170,0,2003
798,363750.0,3.0,1.75,1726,2.0,1726,0,1982
799,385000.0,3.0,1.75,1180,1.0,940,240,1981
800,370000.0,4.0,1.5,1370,1.0,900,470,1972
801,425000.0,3.0,2.5,2670,1.0,2670,0,1988
802,342000.0,3.0,1.0,1260,1.0,720,540,1944
803,345000.0,4.0,1.0,1980,1.5,1980,0,1962
804,724800.0,3.0,2.0,2050,1.0,1180,870,1926
805,725000.0,5.0,2.75,2830,2.0,2830,0,2006
806,605000.0,2.0,1.0,910,1.0,910,0,1909
807,350000.0,4.0,2.5,2440,2.0,2440,0,2009
808,785000.0,3.0,2.0,2180,1.0,1100,1080,1904
809,250000.0,3.0,2.0,1900,1.0,950,950,1966
810,565000.0,3.0,2.25,1520,3.0,1520,0,2013
811,875000.0,3.0,2.0,2220,1.0,1220,1000,1947
812,862500.0,4.0,2.75,3280,2.0,3280,0,1996
813,400000.0,3.0,2.5,2740,2.0,2740,0,1973
814,282613.0,2.0,1.0,830,1.0,830,0,1954
815,174500.0,2.0,1.0,1010,1.0,1010,0,1955
816,306500.0,3.0,2.25,2060,1.0,1560,500,1978
817,445000.0,3.0,2.25,1990,2.0,1990,0,1984
818,433000.0,4.0,2.5,2280,2.0,2280,0,2001
819,306000.0,3.0,2.5,1870,2.0,1870,0,2005
820,620000.0,3.0,2.25,1720,1.5,1450,270,1921
821,245000.0,2.0,1.0,870,1.0,870,0,1941
822,238000.0,3.0,2.0,1020,2.0,720,300,2004
823,523000.0,3.0,1.5,1260,1.5,1260,0,1931
824,522500.0,3.0,2.5,2370,2.0,2370,0,2003
825,180000.0,3.0,1.0,1000,1.0,1000,0,1940
826,375000.0,3.0,1.5,1100,2.0,940,160,2007
827,249000.0,3.0,2.25,1440,1.0,940,500,1982
828,730100.0,4.0,2.5,3120,2.0,3120,0,2003
829,551000.0,2.0,2.0,2260,1.0,2260,0,1990
830,375000.0,4.0,2.5,2790,2.0,2790,0,2005
831,540000.0,1.0,1.0,1140,1.5,1140,0,1920
832,605000.0,3.0,2.25,1290,2.0,1290,0,1987
833,205000.0,5.0,1.75,1730,1.0,1050,680,1978
834,645000.0,4.0,2.5,3160,2.0,3160,0,1983
835,314000.0,4.0,2.5,2340,2.0,2340,0,2003
836,330000.0,3.0,1.5,1170,1.0,1170,0,1960
837,490000.0,2.0,1.0,1160,1.0,1160,0,1937
838,445000.0,3.0,3.0,1970,1.0,1970,0,2010
840,377500.0,3.0,2.25,1410,2.0,1290,120,2005
841,480000.0,4.0,2.5,2430,2.0,2430,0,2009
842,804995.0,5.0,1.5,3360,2.0,3360,0,2014
843,341000.0,3.0,2.5,1480,2.0,1180,300,2012
844,675000.0,5.0,2.5,3200,2.0,3200,0,2009
845,611000.0,3.0,2.5,2134,2.5,2134,0,2008
846,379950.0,3.0,3.25,1860,3.0,1860,0,2007
848,500000.0,2.0,2.5,1310,2.0,1160,150,2006
849,410000.0,3.0,2.0,1700,1.0,890,810,1944
850,415000.0,3.0,2.5,2480,2.0,2480,0,1986
851,297000.0,5.0,2.5,1970,2.0,1970,0,1994
852,575550.0,4.0,2.5,2060,1.0,1440,620,1985
853,534640.0,3.0,2.5,2130,1.0,1210,920,1994
854,352500.0,3.0,2.25,1410,1.0,1170,240,1987
855,488000.0,2.0,2.0,1360,1.0,780,580,1944
856,732000.0,3.0,2.0,1940,1.0,1940,0,1954
857,215000.0,2.0,2.25,1610,2.0,1610,0,1979
858,592500.0,2.0,2.0,1420,1.5,1420,0,1928
859,290000.0,4.0,2.5,1700,2.0,1700,0,1988
860,475000.0,2.0,1.0,1490,1.0,860,630,1929
861,320000.0,3.0,2.5,2680,2.0,2680,0,1990
862,1216000.0,4.0,2.5,3190,1.0,1680,1510,1967
863,290000.0,5.0,1.5,2120,1.5,2120,0,1962
864,487250.0,4.0,2.0,1690,1.5,1550,140,1901
865,339000.0,4.0,2.5,1830,2.0,1830,0,2003
866,440000.0,2.0,1.5,1010,1.5,1010,0,1906
867,366500.0,4.0,2.75,2070,1.0,1120,950,1945
868,462000.0,3.0,1.5,1710,1.5,1410,300,1928
869,560000.0,4.0,1.0,1660,1.5,1260,400,1945
870,285000.0,4.0,1.75,2080,1.0,1040,1040,1955
871,280000.0,3.0,2.5,1270,2.0,1270,0,1993
872,210000.0,3.0,1.0,1080,1.0,1080,0,1942
873,690000.0,3.0,2.0,1610,1.5,1610,0,1940
874,256500.0,2.0,1.0,1120,1.0,1120,0,1980
875,411000.0,4.0,2.75,2500,2.0,2500,0,1966
876,215000.0,3.0,1.0,970,1.0,970,0,1970
877,762000.0,5.0,2.0,3370,1.5,2140,1230,1907
878,359950.0,3.0,1.0,1290,1.0,1290,0,1960
879,480000.0,4.0,3.5,3370,2.0,3370,0,2005
881,390000.0,4.0,2.5,2490,2.0,2490,0,1999
882,413500.0,2.0,1.0,770,1.0,770,0,1924
883,285000.0,1.0,1.5,810,2.0,810,0,1982
884,475000.0,4.0,2.5,3060,1.0,1700,1360,1968
885,386591.0,3.0,2.5,1690,2.0,1150,540,2014
886,524950.0,3.0,1.75,1890,1.0,1290,600,1974
887,241000.0,2.0,2.0,1470,2.0,1470,0,2005
888,461000.0,2.0,1.0,1060,1.0,1060,0,1926
889,810000.0,4.0,2.5,3480,2.0,3480,0,1988
890,885000.0,4.0,2.75,2730,1.5,1550,1180,1921
891,247000.0,3.0,2.25,1580,2.0,1580,0,1986
892,296500.0,3.0,2.75,2170,1.0,1380,790,1978
893,141800.0,2.0,1.0,930,1.0,930,0,1942
894,333000.0,4.0,2.0,1580,2.0,1580,0,1906
895,602000.0,5.0,1.75,3290,1.5,3290,0,1973
896,565000.0,4.0,2.25,2110,2.0,2110,0,1979
897,373000.0,3.0,2.5,1670,2.0,1670,0,1999
898,588000.0,3.0,2.25,2030,1.0,1190,840,1977
899,485000.0,3.0,1.0,1500,1.5,1370,130,1926
900,482500.0,3.0,2.25,1450,2.0,980,470,2005
901,251200.0,4.0,1.5,1310,1.0,1060,250,1953
902,869000.0,5.0,3.25,4180,2.0,2880,1300,1979
903,464000.0,3.0,1.75,1630,1.0,1630,0,1967
904,755000.0,4.0,2.5,2660,2.0,2660,0,1993
905,280000.0,3.0,2.5,1720,2.0,1720,0,2005
906,485000.0,2.0,2.25,1260,3.0,1260,0,2004
907,305000.0,3.0,1.75,1610,1.0,1610,0,1981
908,110700.0,2.0,1.0,680,1.0,680,0,1941
909,850000.0,4.0,3.5,2640,2.0,2640,0,1937
910,350000.0,3.0,2.25,1640,2.0,1640,0,1985
911,319950.0,4.0,1.75,2310,1.0,1650,660,1976
912,700000.0,3.0,1.75,2010,1.0,1230,780,1912
913,368000.0,2.0,1.5,1660,1.0,830,830,1908
914,433500.0,3.0,2.5,2200,2.0,2200,0,2009
915,611000.0,4.0,2.5,2460,2.0,2460,0,1998
916,1000000.0,2.0,1.75,2430,1.0,2430,0,1951
917,307000.0,3.0,1.0,1370,1.0,1370,0,1960
918,442500.0,3.0,1.75,1800,1.0,1800,0,1967
919,485000.0,3.0,1.75,2200,2.0,2200,0,1908
920,367000.0,2.0,1.0,700,1.0,700,0,1945
921,429000.0,3.0,2.5,1920,2.0,1920,0,1995
922,446000.0,5.0,2.75,2190,1.0,1370,820,1978
923,572500.0,3.0,2.25,2030,1.0,1500,530,1984
924,477000.0,3.0,2.5,1350,3.0,1350,0,2005
925,518000.0,3.0,2.5,1680,2.0,1380,300,2008
926,462000.0,5.0,1.75,1250,1.0,1250,0,1966
927,1190000.0,4.0,3.0,2240,1.5,1270,970,1914
928,137000.0,3.0,1.0,950,1.0,950,0,1954
929,530000.0,3.0,3.5,2320,2.0,2060,260,1997
930,818000.0,2.0,2.5,2380,1.0,2380,0,2011
931,640000.0,2.0,2.25,1540,3.0,1540,0,2007
932,298450.0,5.0,3.0,2100,1.0,1200,900,2007
933,575000.0,4.0,2.5,2500,2.0,2500,0,2013
934,730000.0,4.0,2.5,3230,2.0,3230,0,2004
935,551000.0,3.0,2.5,2830,2.0,2830,0,2001
936,271310.0,2.0,1.0,870,1.5,870,0,1906
937,675000.0,4.0,3.0,2690,1.0,2690,0,1954
938,479000.0,3.0,2.5,1260,3.0,1260,0,2008
939,520000.0,4.0,3.5,2680,2.0,2040,640,1942
940,599950.0,3.0,2.5,2660,2.0,2660,0,2014
941,483945.0,2.0,1.75,1480,1.0,840,640,1951
942,390000.0,4.0,2.25,1770,1.0,1190,580,1965
943,192500.0,2.0,1.0,950,1.0,950,0,1926
944,330000.0,2.0,1.0,860,1.0,860,0,1948
945,250000.0,4.0,2.0,1960,1.0,1160,800,1978
946,243000.0,2.0,1.0,1770,1.5,960,810,1943
947,575000.0,4.0,1.75,1280,1.0,860,420,1926
948,639000.0,4.0,2.5,2150,2.0,2150,0,1982
949,710000.0,2.0,1.0,1790,1.0,1040,750,1923
950,675000.0,3.0,2.25,1990,2.0,1990,0,1987
951,405000.0,5.0,2.5,2430,2.0,2430,0,2001
952,615000.0,4.0,2.75,2820,1.0,1860,960,1965
953,490000.0,3.0,1.0,1910,1.0,1010,900,1946
954,467000.0,3.0,2.25,1270,2.0,1040,230,2005
955,480000.0,4.0,2.75,2050,1.0,1180,870,1986
957,760000.0,4.0,1.75,2450,1.0,1630,820,1987
958,387000.0,2.0,2.25,1230,2.0,960,270,2012
959,925000.0,4.0,2.25,2260,1.0,2260,0,1967
960,415000.0,2.0,1.0,1050,1.0,1050,0,1943
961,263000.0,3.0,1.75,1570,2.0,1570,0,1982
962,519900.0,4.0,2.0,1820,1.0,1820,0,1967
963,570000.0,2.0,1.75,1540,1.0,1190,350,1908
964,450000.0,3.0,1.5,2060,1.0,2060,0,1953
966,300000.0,3.0,1.0,1090,1.0,1090,0,1955
967,320000.0,3.0,1.75,1480,1.0,1480,0,1965
968,387500.0,4.0,1.0,1320,1.5,1320,0,1929
969,458000.0,1.0,2.25,2140,1.0,1470,670,1976
971,380000.0,4.0,3.0,2800,2.0,2800,0,2002
972,200000.0,3.0,1.0,1050,1.0,1050,0,1967
973,385000.0,3.0,1.5,1490,1.0,1490,0,1959
974,396675.0,2.0,1.0,1730,2.0,1730,0,1945
975,452000.0,4.0,1.0,1210,1.5,1210,0,1900
976,426000.0,4.0,2.5,2800,2.0,2800,0,2004
977,792000.0,3.0,1.5,1570,2.0,1570,0,1915
978,315000.0,3.0,2.25,1400,1.0,1140,260,1987
979,1275000.0,4.0,2.0,2850,1.0,1450,1400,1970
981,268500.0,2.0,1.0,790,1.0,790,0,1953
982,440000.0,2.0,1.75,1300,2.0,1300,0,1948
983,300000.0,3.0,1.0,2120,1.0,1060,1060,1967
984,525000.0,3.0,1.5,1540,2.0,1540,0,1941
985,978000.0,4.0,2.75,2620,1.5,1720,900,1926
987,700000.0,4.0,1.0,1680,1.5,1680,0,1921
988,315000.0,2.0,1.0,790,1.0,790,0,1955
989,309000.0,3.0,1.0,1092,1.5,1092,0,1918
990,219950.0,3.0,1.5,1650,1.0,1090,560,1967
991,289000.0,3.0,2.5,2090,2.0,2090,0,2002
992,210000.0,4.0,1.75,2180,1.0,1180,1000,1950
993,260000.0,4.0,2.5,1990,2.0,1990,0,1989
994,699000.0,4.0,2.5,2650,2.0,2650,0,2006
996,299950.0,3.0,1.0,910,1.0,740,170,1950
997,749950.0,3.0,2.5,2770,2.0,2770,0,1992
998,1100000.0,3.0,2.0,2390,2.0,2390,0,1939
999,555000.0,3.0,2.5,3050,1.0,3050,0,1987
1000,384000.0,3.0,2.5,1700,2.0,1700,0,2003
1001,499950.0,5.0,3.5,3200,2.0,3200,0,1989
1002,430000.0,3.0,1.75,1200,1.0,1200,0,1906
1003,350000.0,4.0,2.25,2220,2.0,2220,0,1999
1004,620000.0,3.0,2.5,2480,2.0,2480,0,2004
1005,765000.0,4.0,2.25,2560,1.0,1760,800,1976
1006,250000.0,4.0,1.5,2500,1.0,1500,1000,1961
1007,376000.0,2.0,1.0,1150,1.0,1150,0,1947
1008,475000.0,4.0,1.75,1650,1.0,1150,500,1950
1009,120750.0,3.0,1.75,1140,1.0,1140,0,1969
1011,330000.0,3.0,1.0,1180,1.0,1180,0,1959
1012,619500.0,3.0,2.5,1700,2.0,1700,0,1992
1013,345000.0,3.0,1.5,1240,1.0,1240,0,1954
1014,598000.0,5.0,2.25,2890,2.0,2890,0,1977
1015,335000.0,3.0,1.0,1060,1.0,1060,0,1967
1016,372500.0,4.0,1.75,1590,2.0,1590,0,1922
1018,194000.0,1.0,1.0,820,1.0,760,60,2007
1019,507500.0,3.0,2.0,2020,1.0,1020,1000,1963
1020,325000.0,4.0,2.25,1870,1.0,1170,700,1959
1021,329900.0,3.0,2.5,2170,2.0,2170,0,2004
1022,329000.0,4.0,2.5,1600,1.0,830,770,1947
1023,494000.0,4.0,1.75,2090,1.5,1250,840,1925
1024,206000.0,4.0,2.0,1700,1.0,1700,0,1978
1025,423000.0,4.0,1.75,1940,1.0,970,970,1941
1026,259000.0,3.0,1.0,1320,1.0,1320,0,1957
1028,345600.0,5.0,3.5,2800,2.5,2800,0,1903
1029,395000.0,3.0,1.5,1080,1.5,1080,0,1920
1030,625000.0,4.0,2.5,3550,2.0,3550,0,2007
1031,439000.0,3.0,2.0,2010,2.0,1510,500,2003
1032,380000.0,3.0,1.75,1690,2.0,1380,310,2008
1033,440000.0,3.0,1.5,1270,3.0,1270,0,2007
1034,415000.0,3.0,2.25,1970,2.0,1680,290,2008
1035,860000.0,4.0,2.75,3160,2.0,3160,0,2014
1036,500000.0,3.0,2.5,1210,3.0,1210,0,2008
1037,953007.0,4.0,3.5,3120,2.0,2480,640,2008
1038,515000.0,4.0,2.5,2670,2.0,2670,0,2006
1039,772000.0,3.0,2.25,1640,3.0,1640,0,2014
1040,329995.0,4.0,2.5,2303,2.0,2303,0,2013
1041,409316.0,3.0,2.5,1800,2.0,1800,0,2014
1042,490000.0,5.0,3.5,4460,3.0,3280,1180,2013
1043,305000.0,2.0,2.5,1590,2.0,1220,370,2009
1044,785000.0,4.0,3.5,3070,2.0,2190,880,2009
1045,240000.0,2.0,1.75,1330,1.0,1330,0,1993
1046,325000.0,3.0,1.0,990,1.0,990,0,1947
1047,535800.0,4.0,2.5,1900,2.0,1900,0,1994
1048,720000.0,3.0,2.5,2020,3.0,2020,0,2000
1049,374000.0,3.0,1.75,2000,1.0,2000,0,1961
1050,189650.0,2.0,1.75,1100,1.0,1100,0,1980
1051,420850.0,1.0,1.0,960,1.0,960,0,1945
1052,815000.0,4.0,2.75,3488,2.0,3488,0,1998
1053,1065000.0,2.0,1.75,1890,2.0,1890,0,1987
1054,199000.0,4.0,2.0,2030,2.0,2030,0,1950
1055,195000.0,3.0,1.75,1380,1.0,990,390,1981
1057,288400.0,3.0,2.25,1870,2.0,1870,0,1997
1058,442000.0,4.0,2.25,2080,1.0,1220,860,1979
1059,619420.0,4.0,2.75,2450,2.0,2450,0,1988
1060,635000.0,4.0,2.25,2750,1.0,1500,1250,1948
1061,210000.0,3.0,1.0,1240,1.0,1240,0,1916
1062,512500.0,3.0,2.5,1900,2.0,1900,0,1990
1063,567000.0,3.0,2.5,2540,2.0,2540,0,1999
1064,525000.0,3.0,2.75,2100,2.0,1510,590,1998
1065,475000.0,4.0,2.0,1790,1.0,840,950,1909
1066,250000.0,3.0,2.0,1170,1.0,1170,0,1984
1067,220000.0,3.0,1.0,1060,1.0,1060,0,1956
1068,230000.0,5.0,2.0,1930,1.5,1930,0,1941
1069,385500.0,3.0,2.0,1540,1.0,1120,420,1961
1070,895000.0,5.0,3.0,2876,1.0,1970,906,1973
1071,368250.0,3.0,2.5,2150,2.0,2150,0,1988
1072,249900.0,2.0,1.0,1140,1.0,1140,0,1947
1073,350000.0,3.0,1.5,980,1.0,980,0,1969
1074,175000.0,3.0,1.75,1230,1.0,1230,0,1962
1075,270000.0,3.0,1.75,1390,1.0,860,530,1957
1076,495000.0,3.0,3.5,2380,2.0,1670,710,1997
1078,542500.0,5.0,3.25,3010,1.5,2010,1000,1931
1079,330000.0,3.0,1.0,1250,1.0,1250,0,1969
1080,1003000.0,4.0,2.75,2290,2.0,2170,120,1926
1081,299800.0,2.0,1.0,790,1.0,790,0,1925
1082,299900.0,3.0,2.5,2720,2.0,2720,0,2002
1083,691000.0,4.0,2.75,2550,1.0,1700,850,1972
1084,195000.0,2.0,1.0,1080,1.0,1080,0,1972
1085,405000.0,3.0,1.75,2470,1.0,1570,900,1962
1086,360000.0,2.0,0.75,850,1.0,550,300,1909
1087,256750.0,3.0,2.5,1990,1.0,1570,420,1969
1088,332500.0,3.0,2.25,1800,2.0,1800,0,1995
1090,218000.0,3.0,1.0,1020,1.0,1020,0,1956
1091,429000.0,3.0,2.5,2420,2.0,1860,560,1985
1092,589000.0,4.0,2.5,2910,2.0,2910,0,1998
1093,255000.0,3.0,1.5,1060,1.0,1060,0,1973
1094,668750.0,4.0,2.5,2340,1.0,1590,750,1964
1095,344500.0,4.0,2.75,1800,1.0,1050,750,2002
1096,452000.0,4.0,2.0,1660,1.0,850,810,1945
1097,540000.0,3.0,1.75,1300,1.0,1300,0,1983
1098,246000.0,3.0,1.5,1780,1.0,1780,0,1953
1099,535000.0,2.0,1.0,1030,1.0,920,110,1939
1101,430000.0,3.0,1.0,1150,1.0,1150,0,1906
1102,520000.0,4.0,2.5,3290,2.0,3290,0,1992
1103,712000.0,4.0,2.5,3400,2.0,3400,0,2001
1104,450000.0,2.0,1.0,1200,1.0,1070,130,1940
1105,220000.0,4.0,2.5,2160,2.0,2160,0,1993
1106,525000.0,3.0,1.0,1450,1.0,950,500,1948
1107,1220000.0,4.0,2.5,3240,2.0,2060,1180,2008
1108,540000.0,3.0,2.0,1470,2.0,1000,470,2007
1109,600000.0,4.0,2.5,2360,2.0,2360,0,2001
1110,600000.0,3.0,2.25,2230,2.0,2230,0,1987
1111,625000.0,4.0,2.5,2630,2.0,2630,0,1986
1112,150000.0,3.0,1.0,1010,1.0,1010,0,1966
1113,389999.0,3.0,2.25,1445,2.0,1300,145,2003
1114,285000.0,3.0,1.75,2380,1.5,1320,1060,1935
1115,744000.0,4.0,2.75,2830,2.0,2830,0,1998
1116,700000.0,4.0,2.5,3010,2.0,3010,0,1996
1117,318989.0,4.0,2.25,2000,1.0,2000,0,1978
1118,556000.0,3.0,2.25,2020,2.0,2020,0,1998
1119,275000.0,3.0,2.5,2030,2.0,2030,0,1993
1120,430000.0,3.0,2.75,2550,2.0,2550,0,1994
1121,300000.0,2.0,1.0,970,1.0,970,0,1949
1122,396450.0,3.0,1.75,1540,1.0,1540,0,1967
1123,225000.0,2.0,1.0,1396,1.0,1396,0,1940
1124,700000.0,4.0,3.25,2780,2.0,2780,0,2006
1126,655000.0,4.0,3.5,2350,2.0,1670,680,1994
1127,1185000.0,3.0,2.25,2760,2.0,2760,0,1978
1129,413800.0,3.0,2.0,1440,1.0,1440,0,2007
1131,334990.0,4.0,2.5,2220,2.0,2220,0,2014
1133,1030000.0,3.0,4.0,3880,2.0,3700,180,2009
1134,1130000.0,4.0,3.25,3810,1.0,2680,1130,2007
1135,556000.0,3.0,3.0,1960,2.0,1600,360,2007
1136,360000.0,3.0,2.5,1530,3.0,1530,0,2009
1137,480000.0,4.0,2.25,3250,2.0,3250,0,1983
1138,324000.0,3.0,2.5,1750,2.0,1750,0,1994
1139,1050000.0,4.0,3.25,3440,2.0,3440,0,1983
1140,275000.0,1.0,0.75,1170,1.0,880,290,1962
1141,180000.0,3.0,1.0,870,1.0,870,0,1969
1142,749000.0,4.0,2.5,2930,2.0,2930,0,1998
1144,373500.0,2.0,1.0,800,1.0,800,0,1918
1145,770000.0,4.0,2.5,2350,2.0,2350,0,1987
1146,356000.0,2.0,1.75,1060,1.0,1060,0,1977
1147,625000.0,3.0,1.75,2060,1.0,1350,710,1984
1148,494400.0,2.0,1.75,1560,1.0,780,780,1904
1149,585000.0,4.0,1.75,3000,1.0,1500,1500,1950
1150,926300.0,3.0,1.5,1660,2.0,1660,0,1907
1151,600000.0,3.0,1.75,1650,1.0,1040,610,1908
1152,430000.0,4.0,3.0,3220,2.0,2450,770,1990
1153,307000.0,3.0,1.5,2320,1.0,2320,0,1976
1154,604700.0,4.0,2.75,2750,1.0,1720,1030,1981
1155,219900.0,3.0,1.0,910,1.0,910,0,1956
1156,270000.0,2.0,1.5,840,2.0,840,0,2005
1157,432000.0,3.0,2.25,1470,2.0,1090,380,2007
1159,361000.0,3.0,1.0,1100,1.5,1100,0,1922
1160,249950.0,2.0,1.0,940,1.0,940,0,1959
1161,320000.0,3.0,2.0,1110,1.0,1110,0,1978
1162,305000.0,4.0,1.75,2200,1.5,1400,800,1942
1163,503000.0,2.0,1.75,2860,1.0,1510,1350,1948
1164,235750.0,2.0,1.0,740,1.0,740,0,1938
1165,657000.0,4.0,1.75,2740,1.0,1370,1370,1954
1166,385000.0,3.0,1.0,1250,1.0,1250,0,1956
1167,389950.0,4.0,2.5,3140,2.0,3140,0,1991
1168,150000.0,2.0,1.0,820,1.0,820,0,1954
1169,254500.0,4.0,2.75,2570,2.0,1720,850,1998
1170,555000.0,4.0,2.25,2350,1.0,1430,920,1977
1171,1075000.0,4.0,3.0,3600,1.0,2100,1500,1976
1172,245000.0,4.0,2.0,1580,1.0,1040,540,1967
1173,319950.0,2.0,1.0,1070,1.0,1070,0,1949
1174,337000.0,3.0,1.0,1070,1.0,1070,0,1951
1175,492000.0,4.0,2.0,1640,2.0,1640,0,1907
1176,1170000.0,3.0,2.75,2890,2.0,2830,60,1987
1177,348580.0,3.0,1.0,1220,1.0,1220,0,1966
1178,180000.0,2.0,1.0,1400,1.0,900,500,1922
1179,400000.0,3.0,1.0,1040,1.0,1040,0,1942
1180,295000.0,4.0,2.0,980,1.0,980,0,1978
1181,910000.0,4.0,3.25,3340,1.5,2240,1100,1963
1183,431500.0,3.0,3.5,1900,2.0,1430,470,2008
1184,180000.0,4.0,1.5,1740,1.0,1020,720,1962
1185,677000.0,3.0,2.0,2000,1.0,1100,900,1916
1186,1180500.0,3.0,1.75,1610,1.0,1090,520,1973
1187,635700.0,4.0,2.5,3240,1.0,1860,1380,1977
1188,482000.0,5.0,2.25,2230,1.0,1320,910,1978
1189,168000.0,2.0,2.5,1160,2.0,1160,0,1998
1190,805000.0,4.0,2.75,2410,1.0,1410,1000,1950
1191,398000.0,2.0,1.0,590,1.5,590,0,1983
1192,665000.0,4.0,2.5,2600,2.0,2600,0,1996
1193,592500.0,4.0,3.0,2170,1.0,1370,800,1968
1194,940000.0,4.0,2.75,2080,1.5,2080,0,1912
1195,655000.0,4.0,2.5,2860,2.0,2860,0,1999
1196,622500.0,4.0,2.5,2980,2.0,2980,0,2000
1197,380000.0,2.0,2.5,1230,2.0,1060,170,2011
1198,648360.0,4.0,1.75,2260,1.0,1130,1130,1947
1199,432000.0,3.0,2.75,2200,1.0,1100,1100,1982
1200,1050000.0,4.0,2.5,3030,1.5,3030,0,1988
1201,353250.0,2.0,1.0,1060,2.0,1060,0,1979
1203,320000.0,3.0,2.25,998,2.0,798,200,2007
1204,349900.0,4.0,2.5,2052,2.0,2052,0,2014
1205,330000.0,4.0,3.5,3150,2.0,3150,0,2005
1206,408000.0,3.0,2.25,1950,1.0,1950,0,2006
1207,321000.0,3.0,2.25,1347,3.0,1347,0,2010
1208,1051000.0,4.0,3.75,3860,2.5,3860,0,2007
1210,359000.0,3.0,1.5,1360,3.0,1360,0,2008
1211,300000.0,5.0,2.5,2760,2.0,2760,0,2006
1212,380000.0,5.0,3.5,2420,2.0,2420,0,2013
1213,660000.0,3.0,2.5,2450,2.0,2450,0,2010
1214,355000.0,3.0,2.25,1280,3.0,1280,0,2005
1215,259000.0,3.0,2.5,1550,2.0,1550,0,2011
1216,353000.0,1.0,1.0,550,2.0,550,0,2008
1217,430000.0,2.0,2.5,1520,2.0,1240,280,2007
1218,460000.0,3.0,1.0,1670,1.5,1170,500,1939
1219,80000.0,1.0,0.75,430,1.0,430,0,1912
1220,782000.0,4.0,2.5,2380,2.0,2380,0,1991
1221,218000.0,3.0,1.0,960,1.0,960,0,1982
1222,325000.0,3.0,1.0,1920,1.0,1120,800,1952
1224,902000.0,4.0,2.25,2530,1.0,1570,960,1976
1225,556000.0,5.0,2.5,3840,2.0,3840,0,1991
1226,662990.0,3.0,1.75,1240,1.5,1240,0,1926
1227,225000.0,2.0,1.0,1300,1.5,1300,0,1975
1228,439950.0,4.0,2.5,2380,2.0,2380,0,2002
1229,175000.0,2.0,1.0,1300,1.0,1300,0,1958
1230,306000.0,2.0,1.0,780,1.0,780,0,1946
1231,235000.0,4.0,2.5,1810,1.0,1230,580,1970
1232,399500.0,3.0,1.75,2420,2.0,2420,0,1911
1233,478000.0,3.0,1.0,1280,1.5,1280,0,1910
1234,515000.0,2.0,1.0,1680,1.0,1140,540,1941
1235,550000.0,3.0,2.5,2510,2.0,2510,0,1992
1236,149000.0,3.0,1.0,1700,1.0,1700,0,1955
1237,526000.0,3.0,1.75,1680,1.0,960,720,1992
1238,527550.0,1.0,0.75,820,1.0,820,0,1999
1240,625000.0,3.0,2.5,2600,1.0,2600,0,1984
1241,950000.0,5.0,3.25,3400,2.0,3400,0,1999
1242,377691.0,5.0,1.75,2120,1.0,1320,800,1942
1243,648475.0,4.0,2.75,2250,1.0,1200,1050,1951
1244,383000.0,3.0,1.0,1800,1.0,1200,600,1942
1245,535000.0,3.0,2.5,2210,2.0,2210,0,1994
1246,449950.0,3.0,2.0,1560,2.0,1560,0,1923
1247,465425.0,4.0,2.75,2430,1.0,2430,0,1967
1248,675000.0,4.0,2.5,2560,2.0,2560,0,1987
1249,599000.0,3.0,2.75,1960,1.5,1410,550,1926
1250,416000.0,3.0,1.5,1110,1.0,1110,0,1963
1251,595000.0,2.0,1.5,1030,1.0,830,200,1924
1252,200000.0,4.0,1.0,1350,1.0,1350,0,1966
1253,402000.0,3.0,2.0,1540,2.0,1540,0,2005
1254,433000.0,4.0,1.75,1830,1.0,1010,820,1966
1255,275000.0,4.0,1.5,1930,2.0,1930,0,1979
1256,410000.0,3.0,2.0,1650,1.5,1650,0,1983
1257,554820.0,4.0,2.0,3510,1.0,2210,1300,1965
1258,1325000.0,4.0,3.0,3370,1.0,1860,1510,1988
1259,735000.0,3.0,2.5,2390,2.0,2390,0,1984
1260,607000.0,3.0,1.0,1230,1.0,1230,0,1951
1261,549900.0,4.0,3.0,2830,2.0,2830,0,1987
1262,258000.0,3.0,1.75,1620,1.0,1310,310,1988
1263,661254.0,4.0,4.0,2290,1.5,1690,600,1940
1264,945000.0,4.0,2.0,2840,1.0,1420,1420,1952
1266,132500.0,3.0,1.0,1080,1.0,1080,0,1967
1267,467100.0,3.0,1.75,1620,1.0,1190,430,1973
1269,641000.0,3.0,1.75,1620,1.0,940,680,1926
1270,350000.0,3.0,1.0,1010,1.0,1010,0,1947
1271,335000.0,4.0,2.5,1750,1.0,1240,510,1983
1273,440000.0,4.0,2.5,2560,1.0,1280,1280,1965
1274,464600.0,3.0,1.75,1120,1.5,1120,0,1925
1276,300000.0,2.0,1.0,1340,1.0,1340,0,1947
1277,670500.0,4.0,2.0,1590,1.0,1590,0,1951
1278,552000.0,3.0,1.0,1430,1.0,1080,350,1919
1279,244000.0,4.0,1.0,1450,1.0,1450,0,1943
1280,788600.0,4.0,2.75,3500,2.0,3500,0,2005
1281,445000.0,3.0,2.0,1630,1.0,1630,0,1987
1282,530000.0,4.0,1.75,1814,1.0,944,870,1951
1283,90000.0,2.0,1.0,580,1.0,580,0,1943
1284,585000.0,3.0,2.0,1670,1.5,1670,0,1931
1285,498000.0,2.0,2.0,1140,1.0,1140,0,1924
1286,379000.0,2.0,1.0,800,1.0,800,0,1940
1287,462000.0,3.0,1.75,1300,1.0,820,480,1919
1288,388000.0,4.0,2.5,2440,2.0,2440,0,1993
1289,255000.0,3.0,2.0,1490,1.5,1490,0,1984
1290,665000.0,3.0,2.75,1800,1.0,1320,480,1966
1291,550000.0,3.0,2.0,1830,1.0,1830,0,1959
1292,606000.0,3.0,1.0,1500,1.0,1000,500,1947
1293,334000.0,4.0,2.5,2210,1.0,1410,800,1965
1294,360000.0,3.0,2.0,1270,3.0,1270,0,2006
1295,235000.0,2.0,1.0,1140,1.5,1010,130,2007
1296,580000.0,3.0,2.5,1620,3.0,1470,150,2008
1297,355000.0,3.0,2.0,1220,3.0,1220,0,2007
1298,375000.0,2.0,2.5,750,2.0,750,0,2006
1299,372000.0,4.0,1.75,1960,1.0,1340,620,1979
1300,479000.0,3.0,1.0,1370,1.5,1370,0,1924
1303,501000.0,2.0,1.0,1010,1.0,1010,0,1924
1304,245000.0,3.0,1.75,1260,1.0,1260,0,1994
1305,496700.0,3.0,2.5,1740,2.0,1740,0,1989
1306,347000.0,4.0,1.5,2670,2.0,2670,0,1996
1307,199000.0,2.0,1.0,720,1.0,720,0,1943
1308,440500.0,3.0,2.5,2460,2.0,2460,0,2007
1309,820000.0,4.0,2.5,3670,2.0,3670,0,2005
1310,325000.0,4.0,3.5,2630,1.5,1640,990,1984
1311,195000.0,3.0,1.75,1570,1.0,1570,0,1991
1312,675000.0,3.0,3.0,2980,1.0,1820,1160,1981
1313,295000.0,3.0,2.5,1560,2.0,1560,0,2003
1314,355300.0,3.0,2.5,1620,1.0,1620,0,1955
1315,276000.0,3.0,1.0,1140,1.0,1140,0,1960
1316,460000.0,2.0,1.5,2730,1.0,1570,1160,1976
1317,880000.0,3.0,2.0,2130,1.0,2130,0,1989
1318,370000.0,3.0,2.5,1780,2.0,1780,0,2001
1319,346000.0,4.0,2.5,2100,2.0,2100,0,2009
1320,172500.0,3.0,1.0,1140,1.0,1140,0,1972
1321,379950.0,3.0,1.5,1690,1.0,1140,550,1956
1322,468000.0,2.0,1.0,1160,1.0,860,300,1942
1323,477000.0,4.0,2.75,1720,2.0,1720,0,1978
1324,529000.0,3.0,1.0,1210,1.5,1210,0,1924
1325,312000.0,3.0,1.5,1255,3.0,1255,0,2004
1326,326100.0,2.0,1.0,880,1.0,880,0,1942
1327,360000.0,3.0,1.0,1050,1.5,1050,0,1954
1328,438000.0,3.0,1.75,1650,1.0,1650,0,1961
1329,360000.0,3.0,1.0,1570,1.0,1570,0,1954
1330,1050000.0,4.0,2.5,2920,1.0,1470,1450,1921
1331,688000.0,4.0,3.0,3000,1.5,1970,1030,1913
1332,585000.0,3.0,1.75,1850,1.0,1850,0,1983
1333,265000.0,3.0,2.5,1440,1.0,1000,440,1983
1334,375000.0,3.0,1.75,1440,1.0,1440,0,1973
1335,326500.0,3.0,1.0,1810,2.0,1810,0,1970
1336,160000.0,2.0,1.0,1180,1.0,1180,0,1918
1338,735000.0,5.0,2.75,3390,2.0,3390,0,2004
1339,400000.0,2.0,1.0,1470,1.0,1470,0,1940
1340,800000.0,4.0,2.5,2680,1.0,1380,1300,1952
1341,949880.0,4.0,2.25,2290,2.0,2290,0,1978
1342,405000.0,3.0,1.75,1980,1.0,1310,670,1949
1343,399000.0,4.0,2.5,2870,2.0,2540,330,1979
1344,730001.0,3.0,2.0,1840,1.0,1010,830,1951
1346,260000.0,3.0,2.0,1630,1.0,1630,0,2003
1347,751750.0,2.0,2.0,1880,1.5,1880,0,1902
1348,325000.0,3.0,1.75,1780,1.0,1780,0,1983
1349,344950.0,4.0,2.0,2330,1.0,1400,930,1941
1350,457500.0,3.0,1.75,1840,1.0,1050,790,1925
1351,389000.0,5.0,2.0,2330,1.0,1190,1140,1962
1352,515000.0,4.0,2.5,3200,2.0,3200,0,2005
1353,732000.0,3.0,2.5,2330,2.0,1410,920,2004
1354,415000.0,3.0,2.25,1950,1.0,1350,600,1964
1356,535000.0,2.0,1.0,1040,1.0,1040,0,1951
1357,540000.0,4.0,4.25,1960,2.0,1960,0,1940
1358,525000.0,5.0,3.0,2750,1.5,1750,1000,1926
1359,570000.0,3.0,1.75,1930,1.0,1930,0,1977
1361,283200.0,4.0,2.5,1982,2.0,1982,0,2004
1362,1100000.0,3.0,2.75,2640,1.5,1750,890,1926
1363,830000.0,4.0,2.5,1850,1.0,1430,420,1978
1364,495000.0,4.0,2.25,1940,1.0,1430,510,1956
1365,292050.0,5.0,3.0,2840,1.0,1710,1130,2003
1366,415000.0,5.0,1.5,1900,1.0,1130,770,1961
1367,295832.0,5.0,1.0,1410,1.0,960,450,1955
1368,450000.0,4.0,2.5,2520,2.0,2520,0,1999
1370,857000.0,4.0,3.0,3720,2.0,3720,0,1991
1371,499950.0,3.0,3.5,1820,2.0,1430,390,2014
1372,465000.0,3.0,2.0,1560,1.0,1560,0,1967
1373,329000.0,3.0,1.0,1600,1.0,1150,450,1964
1374,475000.0,3.0,2.0,1230,1.0,1230,0,1984
1375,255000.0,3.0,1.0,960,1.0,960,0,1955
1376,435000.0,3.0,1.0,1270,1.5,1270,0,1928
1377,685000.0,3.0,2.5,2810,2.0,2810,0,2001
1378,715000.0,2.0,2.5,2160,1.0,2160,0,2002
1379,780000.0,3.0,3.0,2520,1.5,1560,960,1925
1380,345000.0,2.0,1.5,1180,2.0,990,190,2005
1381,355000.0,4.0,2.25,1810,2.0,1810,0,2003
1382,282000.0,3.0,2.5,1680,1.0,1240,440,1994
1383,244000.0,3.0,1.0,910,1.0,910,0,1971
1384,967500.0,3.0,3.75,3250,2.0,2370,880,1951
1385,375000.0,3.0,1.5,2000,1.0,1520,480,1965
1387,527500.0,3.0,1.75,2310,1.0,1760,550,1977
1388,994000.0,3.0,2.25,2510,1.5,1810,700,1932
1389,313000.0,3.0,1.75,1320,1.0,1320,0,1948
1390,587000.0,3.0,2.25,2370,2.0,2370,0,1979
1391,304000.0,3.0,1.0,900,1.0,900,0,1972
1392,675000.0,3.0,2.5,2540,2.0,2540,0,1940
1393,305000.0,4.0,1.0,2100,1.0,1050,1050,1968
1394,280000.0,3.0,1.0,1200,1.0,920,280,1943
1395,960000.0,5.0,4.0,3720,2.0,3720,0,2005
1396,500000.0,3.0,2.25,1760,2.0,1760,0,1988
1397,274950.0,3.0,1.75,1670,1.0,1320,350,1987
1398,455600.0,3.0,2.5,2420,2.0,2420,0,1998
1399,970000.0,5.0,3.0,3480,2.0,3480,0,1964
1400,312900.0,4.0,2.5,1630,2.0,1630,0,2003
1401,535000.0,4.0,2.5,2340,2.0,2340,0,1921
1402,427000.0,2.0,1.0,920,1.0,920,0,1910
1403,405000.0,2.0,1.0,910,1.0,910,0,1942
1404,480000.0,3.0,1.0,1150,1.0,1150,0,1943
1405,725000.0,3.0,1.5,2500,1.5,1450,1050,1940
1406,293000.0,4.0,2.5,3250,1.0,3250,0,1973
1407,268000.0,4.0,2.0,1930,1.0,1030,900,1967
1408,475000.0,4.0,3.5,3400,2.0,2500,900,1991
1409,488000.0,3.0,2.5,1590,3.0,1590,0,1985
1410,760000.0,4.0,2.5,3330,2.0,3330,0,2009
1412,754950.0,3.0,2.5,2610,2.0,2610,0,2014
1413,263900.0,3.0,2.5,1658,2.0,1658,0,2014
1414,460000.0,3.0,3.5,1600,2.0,1240,360,2006
1415,399950.0,3.0,3.0,1296,3.0,1296,0,2009
1416,370000.0,2.0,2.25,1280,2.0,1080,200,2009
1418,450800.0,4.0,3.25,2510,2.0,2510,0,2009
1419,627000.0,3.0,3.5,2710,2.0,1650,1060,2005
1420,495000.0,3.0,2.5,1750,3.0,1750,0,2013
1421,310000.0,3.0,1.0,1430,1.5,1430,0,1927
1422,550000.0,4.0,1.0,1660,1.0,930,730,1933
1423,215000.0,2.0,1.0,1320,1.0,1320,0,1943
1424,799000.0,4.0,3.0,2580,2.0,2580,0,1984
1425,630000.0,4.0,2.5,2740,2.0,2740,0,1993
1426,267000.0,3.0,2.5,2495,2.0,2495,0,2007
1428,365000.0,3.0,1.5,1300,1.0,1300,0,1963
1429,544500.0,4.0,2.5,2230,1.0,1450,780,1974
1430,599000.0,4.0,2.75,2020,1.0,1010,1010,1917
1431,815000.0,4.0,2.25,2000,2.0,2000,0,2001
1432,254000.0,2.0,1.0,1060,1.0,1060,0,1952
1433,740000.0,2.0,1.75,2080,1.0,1080,1000,1923
1434,225000.0,3.0,2.0,2030,1.0,1220,810,1979
1435,925000.0,3.0,2.5,2690,2.0,1840,850,1943
1436,1285000.0,4.0,2.5,3240,1.0,2260,980,1946
1437,537000.0,3.0,2.5,1550,2.0,1550,0,1999
1438,335000.0,4.0,2.0,1480,1.0,740,740,1910
1439,840000.0,4.0,2.75,3040,2.0,2100,940,1906
1440,224000.0,3.0,1.5,1560,1.0,1040,520,1964
1441,395000.0,3.0,2.5,2250,2.0,2250,0,2006
1442,450000.0,3.0,1.0,1100,1.0,1100,0,1917
1443,681000.0,3.0,1.0,1700,1.5,1700,0,1907
1444,898000.0,5.0,1.5,2680,1.0,1450,1230,1963
1445,370000.0,3.0,1.0,800,1.0,800,0,1908
1446,429000.0,2.0,1.75,1350,1.0,1350,0,2005
1447,150000.0,3.0,1.0,820,1.5,820,0,1910
1448,555000.0,3.0,2.5,3160,2.0,2650,510,2006
1449,326000.0,3.0,2.75,1720,1.0,1720,0,1958
1450,225000.0,3.0,2.5,1680,2.0,1680,0,1994
1451,245100.0,3.0,1.75,1300,1.0,1300,0,1996
1452,665000.0,3.0,2.5,2190,2.0,2190,0,1987
1453,535000.0,3.0,2.5,1720,2.0,1720,0,1994
1454,305000.0,3.0,1.0,1160,1.0,1160,0,1968
1456,215000.0,3.0,1.75,1210,1.0,1210,0,1983
1457,432500.0,3.0,1.75,1980,1.0,1270,710,1965
1458,655000.0,4.0,2.5,2990,2.0,2990,0,2003
1459,266200.0,3.0,1.5,1430,1.0,1430,0,1966
1460,244615.0,3.0,2.5,2060,2.0,2060,0,1999
1461,460000.0,4.0,3.0,2230,2.0,2230,0,1991
1462,370000.0,4.0,2.5,3090,2.0,3090,0,1995
1464,1175000.0,3.0,2.5,1970,1.0,1100,870,1937
1465,189000.0,2.0,2.0,1700,1.0,850,850,1927
1466,820000.0,3.0,2.5,2510,2.0,2510,0,1995
1469,438750.0,3.0,1.75,1610,1.0,1610,0,1947
1470,1210000.0,4.0,2.75,3650,2.0,2530,1120,1951
1471,600000.0,4.0,2.0,2510,1.0,2510,0,1960
1472,589000.0,3.0,1.0,1110,1.5,1110,0,1932
1473,590000.0,3.0,2.0,1650,2.0,1650,0,1926
1474,479900.0,3.0,2.0,1980,1.0,1980,0,1994
1475,210000.0,2.0,1.5,880,2.0,880,0,2007
1476,745000.0,3.0,1.75,1490,1.0,1140,350,1947
1477,840500.0,3.0,2.0,2520,1.5,1410,1110,1906
1478,420000.0,3.0,1.75,1820,1.0,1250,570,1977
1480,840000.0,4.0,2.5,3420,2.0,3420,0,2000
1481,681716.0,4.0,2.5,3150,2.0,3150,0,2006
1482,600000.0,3.0,1.75,1580,1.0,1150,430,1967
1483,380000.0,3.0,2.0,1660,1.0,1660,0,1949
1484,168500.0,3.0,1.0,1100,1.0,1100,0,1969
1485,355000.0,2.0,1.0,1270,1.0,960,310,1920
1486,277000.0,4.0,1.0,1450,1.0,990,460,1964
1487,236000.0,4.0,2.25,1830,1.0,1200,630,1989
1488,270000.0,3.0,1.75,1300,1.0,650,650,1918
1489,700000.0,2.0,1.75,2320,1.5,1720,600,1925
1490,425000.0,4.0,2.75,1680,1.0,1080,600,1979
1491,635000.0,3.0,2.5,2300,1.5,2000,300,1921
1492,510250.0,3.0,1.75,1400,1.0,870,530,1951
1493,960000.0,4.0,2.25,2410,2.0,1800,610,1929
1494,254000.0,3.0,2.0,1480,1.0,1480,0,1992
1495,299000.0,3.0,1.0,1390,1.5,1390,0,1954
1496,175000.0,2.0,1.0,830,1.0,830,0,1996
1497,157500.0,2.0,1.0,740,1.0,740,0,1949
1498,580000.0,5.0,2.0,1940,1.0,970,970,1945
1499,124740.0,3.0,1.0,1340,1.0,1340,0,1978
1501,285000.0,2.0,1.0,800,1.0,800,0,1954
1502,242000.0,3.0,1.75,1310,1.0,1310,0,1979
1503,840000.0,4.0,1.75,2330,2.0,1300,1030,1924
1504,474800.0,2.0,3.25,1400,3.0,1400,0,2000
1505,490000.0,4.0,2.5,2360,2.0,2360,0,2003
1506,465000.0,3.0,2.25,1840,2.0,1840,0,2003
1507,515000.0,4.0,2.5,2680,2.0,2680,0,2004
1508,430000.0,3.0,3.75,3890,1.0,2390,1500,1943
1509,253400.0,3.0,2.0,1400,1.0,1400,0,1968
1510,355000.0,3.0,2.5,2400,1.0,2400,0,1990
1511,740000.0,4.0,2.25,2920,2.0,2920,0,1998
1512,186950.0,2.0,2.0,1390,2.0,1390,0,1986
1513,306000.0,3.0,2.5,1680,2.0,1680,0,1984
1514,510000.0,4.0,1.5,2040,1.0,1020,1020,1961
1515,345000.0,2.0,1.0,1080,1.0,1080,0,1940
1516,875000.0,3.0,2.75,2280,1.0,1280,1000,1917
1519,499950.0,4.0,2.5,2798,2.0,2798,0,2012
1520,739000.0,3.0,2.5,2810,2.0,2810,0,2005
1521,363000.0,4.0,2.5,3753,2.0,3336,417,2008
1522,782000.0,4.0,3.5,3910,2.0,3130,780,2007
1523,325000.0,2.0,2.5,1050,2.0,1050,0,2005
1524,485000.0,4.0,1.0,1600,1.5,1600,0,1916
1525,452000.0,4.0,2.25,2590,1.0,1340,1250,1968
1526,264950.0,4.0,2.25,1720,1.0,1120,600,1978
1528,267500.0,3.0,1.75,1590,1.0,1090,500,1957
1529,565000.0,4.0,2.5,2440,2.0,2440,0,1996
1530,535000.0,3.0,2.5,1360,3.0,1310,50,2003
1531,389000.0,2.0,1.0,910,1.0,910,0,1952
1532,400000.0,4.0,1.5,1390,1.0,1140,250,1965
1533,264000.0,3.0,1.5,1470,1.0,1470,0,1958
1534,690000.0,4.0,2.5,2920,2.0,2920,0,1990
1535,412000.0,3.0,1.75,1950,1.0,1950,0,1985
1536,695000.0,3.0,2.5,2390,2.0,2390,0,2006
1537,246500.0,3.0,1.5,1270,1.0,1270,0,1964
1538,230000.0,2.0,1.0,950,1.0,950,0,1958
1539,302000.0,2.0,1.0,900,1.0,900,0,1925
1540,820000.0,4.0,2.25,2280,1.5,1960,320,1940
1541,145000.0,3.0,1.0,1010,1.0,1010,0,1954
1542,436500.0,2.0,1.0,1260,1.0,1040,220,1951
1544,672000.0,3.0,2.5,2620,2.0,2620,0,1992
1545,680000.0,3.0,2.25,2330,1.5,1520,810,1927
1546,750500.0,5.0,3.0,2170,1.5,1450,720,1911
1547,550000.0,5.0,2.0,2450,1.0,1240,1210,1900
1548,266500.0,4.0,1.75,1880,1.0,1180,700,1978
1549,619000.0,4.0,2.0,2300,1.5,1550,750,1915
1550,405000.0,3.0,2.0,1240,1.0,1240,0,1988
1551,300000.0,2.0,1.0,820,1.0,820,0,1916
1552,231000.0,4.0,2.0,1530,2.0,1530,0,1942
1553,790000.0,5.0,3.25,2900,1.0,1890,1010,1967
1554,400000.0,4.0,2.75,1240,1.0,800,440,1987
1556,450000.0,4.0,2.0,2240,1.0,1120,1120,1956
1557,595000.0,3.0,2.0,1480,1.0,750,730,1928
1558,332000.0,3.0,2.25,2270,1.0,1380,890,1977
1559,155000.0,3.0,1.0,1250,1.0,1030,220,1949
1560,400000.0,5.0,2.0,1930,1.0,1020,910,1962
1561,349000.0,4.0,1.75,1700,1.0,1120,580,1981
1562,529000.0,3.0,1.0,1590,1.0,1590,0,1944
1563,405000.0,5.0,1.75,1880,1.0,960,920,1963
1564,635200.0,4.0,1.75,1640,1.0,920,720,1921
1565,540000.0,3.0,1.5,2600,1.0,1400,1200,1940
1566,402000.0,2.0,1.0,710,2.0,710,0,1943
1568,329932.0,3.0,1.5,1460,1.0,1100,360,1971
1569,300000.0,3.0,2.5,2080,2.0,2080,0,1989
1570,525000.0,5.0,2.5,2630,2.0,2630,0,2003
1572,602500.0,4.0,2.5,2760,2.0,2760,0,1999
1573,400000.0,4.0,2.0,1670,1.0,1670,0,1955
1574,445000.0,4.0,1.75,1990,1.5,1190,800,1944
1575,525000.0,3.0,3.0,2600,1.5,1890,710,1989
1576,395000.0,2.0,1.0,1320,1.5,1320,0,1909
1577,510000.0,3.0,1.5,2240,2.0,1370,870,1929
1578,723000.0,4.0,2.25,1960,1.0,1290,670,1959
1579,503000.0,3.0,2.0,2590,2.0,1980,610,1988
1580,672500.0,4.0,2.75,2620,2.0,2620,0,2000
1581,860000.0,3.0,2.5,2770,2.0,2770,0,1991
1582,475300.0,3.0,1.0,2110,1.0,1110,1000,1924
1583,295000.0,4.0,2.5,2290,2.0,2290,0,2001
1585,250000.0,2.0,1.0,1110,1.0,1110,0,1951
1586,658000.0,4.0,2.75,3310,2.0,3310,0,2008
1587,83000.0,2.0,1.0,900,1.0,900,0,1918
1588,685000.0,3.0,1.75,1940,1.0,1440,500,1960
1589,210000.0,3.0,1.75,1590,2.0,1590,0,1986
1590,650880.0,3.0,2.5,2930,2.0,2930,0,2008
1591,350000.0,4.0,2.5,2040,2.0,2040,0,2011
1592,305000.0,2.0,2.25,1000,3.0,1000,0,2006
1593,645000.0,3.0,3.25,1730,2.0,1320,410,2008
1594,385000.0,3.0,1.0,1220,1.0,1220,0,1901
1595,860000.0,3.0,2.25,3060,2.0,3060,0,1983
1596,395000.0,4.0,2.5,2910,2.0,2910,0,2002
1597,260000.0,3.0,1.75,1050,1.0,1050,0,1980
1598,196440.0,3.0,2.0,1560,1.0,1560,0,1992
1599,425000.0,3.0,1.75,1680,1.0,840,840,1900
1601,369000.0,3.0,2.0,1550,1.0,1150,400,1959
1603,349900.0,3.0,2.5,2200,2.0,2200,0,1990
1604,650000.0,2.0,2.5,1740,2.0,1210,530,1994
1605,299950.0,3.0,1.0,1210,1.0,1210,0,1955
1606,625000.0,4.0,3.25,4240,2.0,3550,690,1989
1607,190000.0,3.0,2.25,1590,1.0,1090,500,1978
1609,659000.0,4.0,2.5,3190,1.0,2210,980,1946
1610,490000.0,3.0,1.75,1920,1.0,960,960,1947
1611,415000.0,2.0,1.75,1340,1.0,1340,0,2004
1612,750000.0,3.0,1.75,1700,1.0,1460,240,1947
1613,700000.0,4.0,2.5,2310,1.5,1490,820,1927
1614,425000.0,3.0,1.75,1510,1.0,1240,270,1989
1615,642000.0,3.0,2.5,2670,1.0,2670,0,1987
1616,655000.0,4.0,2.25,2060,1.0,1440,620,1983
1617,1365000.0,3.0,2.5,2090,1.5,2090,0,1928
1618,458000.0,5.0,2.5,3090,1.0,2990,100,1957
1619,330000.0,2.0,2.5,1240,2.0,1240,0,2007
1620,384950.0,3.0,2.5,1860,2.0,1860,0,2000
1621,560000.0,3.0,1.5,2000,1.0,2000,0,1953
1622,950000.0,4.0,1.75,2500,1.0,1500,1000,1970
1623,465000.0,4.0,2.25,1820,1.0,1340,480,1977
1624,425000.0,3.0,2.25,1820,1.0,1260,560,1974
1625,315000.0,3.0,2.0,1060,1.0,1060,0,1981
1626,530000.0,3.0,2.5,1950,2.0,1950,0,1988
1627,399000.0,2.0,1.0,940,1.0,940,0,1911
1628,168000.0,2.0,1.5,1220,1.5,1220,0,1976
1630,374000.0,3.0,1.0,1200,1.0,1200,0,1971
1631,740000.0,5.0,3.75,3990,2.0,3090,900,1937
1632,280000.0,2.0,1.0,1880,1.0,940,940,1919
1633,322000.0,4.0,2.5,2280,2.0,2280,0,1994
1634,459900.0,3.0,1.75,2580,1.0,1290,1290,1951
1635,750000.0,4.0,2.75,2600,1.0,1560,1040,1976
1636,1256500.0,4.0,2.5,3150,2.0,3150,0,1966
1638,427000.0,5.0,2.75,2220,1.0,1230,990,1973
1639,800000.0,2.0,2.25,1730,2.0,1730,0,1947
1640,735000.0,4.0,3.0,2840,1.5,2060,780,1931
1641,642000.0,4.0,2.5,2560,2.0,2560,0,1992
1642,240000.0,3.0,2.0,1330,1.0,630,700,1900
1643,645500.0,2.0,1.0,1890,1.5,1890,0,1909
1645,475000.0,2.0,2.0,1540,2.0,1540,0,1983
1646,568000.0,4.0,2.0,2340,1.0,1170,1170,1966
1647,325000.0,3.0,1.75,2180,1.0,1090,1090,1961
1648,825500.0,3.0,2.5,2780,2.0,2780,0,2009
1649,499431.0,4.0,2.75,2620,2.0,2620,0,2013
1650,919204.0,4.0,3.5,3760,2.0,2860,900,2014
1651,545000.0,4.0,2.5,2720,2.0,2720,0,2012
1652,660000.0,3.0,2.25,2675,2.0,2675,0,1984
1653,538888.0,5.0,2.75,2080,2.0,2080,0,1987
1654,693000.0,3.0,2.5,2460,2.0,2460,0,1996
1655,289950.0,3.0,2.5,1960,2.0,1960,0,2004
1656,587000.0,4.0,2.5,2550,2.0,2550,0,1992
1657,615000.0,3.0,2.25,1760,3.0,1760,0,2014
1658,459000.0,3.0,1.75,1620,1.0,1090,530,1974
1659,243000.0,3.0,1.75,1790,1.0,1040,750,1960
1661,660000.0,4.0,1.75,2780,2.0,2780,0,1978
1663,250000.0,1.0,1.0,750,1.0,750,0,1918
1664,315000.0,3.0,1.0,960,1.0,960,0,1952
1665,404000.0,3.0,1.5,2030,1.0,1330,700,1963
1666,559900.0,3.0,2.75,2930,1.0,1860,1070,2004
1667,285000.0,2.0,2.5,1380,2.0,1140,240,2011
1668,500000.0,3.0,2.0,1720,1.0,960,760,1941
1669,380000.0,2.0,1.0,1210,1.0,1060,150,1950
1670,469000.0,3.0,1.0,950,1.5,950,0,1948
1671,405000.0,2.0,1.75,1710,2.0,1330,380,1920
1672,439900.0,2.0,2.0,1410,1.5,1410,0,1909
1673,525000.0,4.0,2.5,2910,2.0,2910,0,2006
1674,580000.0,4.0,2.5,2220,2.0,2220,0,1988
1675,1250000.0,5.0,3.25,3160,2.0,3160,0,1972
1676,275000.0,3.0,2.0,1380,1.0,1380,0,2008
1677,629000.0,3.0,2.0,1760,1.0,960,800,1920
1678,395000.0,1.0,1.0,730,1.0,730,0,1911
1679,965000.0,4.0,2.5,2460,2.0,1620,840,1938
1680,820000.0,3.0,1.75,2160,1.0,1390,770,1960
1681,661000.0,4.0,2.25,1990,1.5,1420,570,1932
1682,789000.0,3.0,3.0,3740,2.0,3740,0,1991
1683,668500.0,4.0,2.5,2710,2.0,2710,0,1999
1684,350000.0,3.0,2.5,2680,2.0,2680,0,1990
1685,250000.0,4.0,2.0,1850,1.0,1540,310,1978
1686,725995.0,4.0,2.5,3190,2.0,3190,0,2001
1687,1000000.0,3.0,2.5,2730,2.0,2730,0,1998
1688,686000.0,3.0,1.5,1840,2.0,1840,0,1961
1689,665000.0,4.0,2.5,2720,2.0,2720,0,1987
1691,653000.0,3.0,2.5,2290,2.0,2290,0,2006
1692,430000.0,2.0,1.0,990,1.0,990,0,1947
1693,305000.0,2.0,1.5,1140,2.0,1140,0,1988
1694,809000.0,4.0,1.5,1840,2.0,1840,0,1917
1695,440150.0,2.0,1.0,1110,1.0,1000,110,1947
1696,615000.0,4.0,2.5,2150,2.0,2150,0,1985
1697,1035000.0,3.0,2.5,2230,2.0,2230,0,2003
1698,455000.0,2.0,1.0,1170,1.0,970,200,1941
1699,635000.0,3.0,2.5,1960,1.0,980,980,1940
1700,675000.0,3.0,2.25,2610,2.0,2610,0,1988
1701,316000.0,3.0,2.25,2130,1.0,1570,560,1987
1702,955000.0,3.0,2.25,3020,2.0,2720,300,1969
1703,985000.0,3.0,1.75,1670,2.0,1670,0,1912
1704,465500.0,3.0,1.75,1890,1.0,1290,600,1965
1705,305000.0,3.0,1.0,950,1.0,950,0,1950
1706,645000.0,4.0,2.5,2430,1.0,1670,760,1963
1707,730000.0,4.0,2.0,2360,1.0,1260,1100,1939
1708,366000.0,3.0,1.75,1510,1.0,1510,0,1967
1709,290000.0,3.0,2.5,2080,2.0,2080,0,2002
1710,472500.0,3.0,2.0,1750,1.0,1490,260,1982
1711,550000.0,3.0,2.0,1810,1.5,1810,0,1925
1712,410000.0,4.0,1.75,1790,1.0,1490,300,1969
1713,440000.0,4.0,2.75,2340,1.0,1720,620,1967
1714,535000.0,3.0,2.5,1690,2.0,1690,0,1984
1715,300000.0,4.0,2.5,2070,2.0,2070,0,2003
1716,432500.0,3.0,2.5,2240,2.0,2240,0,2002
1718,492000.0,3.0,1.75,2770,1.0,1580,1190,1978
1719,199950.0,3.0,1.0,1010,1.0,1010,0,1969
1720,439800.0,3.0,1.5,1120,1.0,1120,0,1956
1721,320000.0,5.0,2.5,3020,1.0,1510,1510,1978
1723,345000.0,3.0,1.75,1990,1.0,1320,670,1963
1724,274950.0,3.0,1.0,1450,1.0,1050,400,1958
1725,270000.0,4.0,2.5,1920,2.0,1920,0,1998
1726,342000.0,2.0,2.5,1175,2.0,740,435,2005
1727,327000.0,3.0,1.5,1320,1.0,1320,0,1970
1729,455000.0,2.0,1.0,1140,1.0,850,290,1947
1730,540000.0,4.0,1.75,1720,1.5,1460,260,1925
1731,411000.0,4.0,2.75,2150,1.0,1240,910,1976
1732,544000.0,3.0,1.5,1790,1.5,1790,0,1910
1733,802000.0,2.0,2.5,2210,1.0,2210,0,2003
1734,568500.0,3.0,2.75,2180,1.0,1310,870,1981
1735,391000.0,3.0,2.25,1410,2.0,1290,120,2004
1736,298000.0,3.0,2.5,1950,2.0,1950,0,2010
1737,400000.0,3.0,2.5,1495,3.0,1405,90,2006
1738,425000.0,3.0,2.25,1660,1.0,1110,550,1979
1739,328500.0,3.0,2.5,1950,2.0,1950,0,1990
1740,650000.0,5.0,2.75,2550,1.5,2550,0,1902
1741,850000.0,3.0,1.75,1370,1.0,770,600,1911
1742,930000.0,4.0,2.5,2200,2.0,1430,770,1908
1743,530000.0,3.0,1.75,1250,1.5,1250,0,1942
1744,495000.0,4.0,2.25,2220,1.0,1110,1110,1961
1745,500000.0,3.0,1.75,1620,1.0,830,790,1945
1746,325000.0,3.0,1.75,2250,1.0,2250,0,1980
1747,365000.0,3.0,2.5,1720,2.0,1720,0,1990
1748,471000.0,4.0,2.5,3030,2.0,2020,1010,1998
1749,223000.0,3.0,1.0,1030,1.0,1030,0,1961
1750,503000.0,3.0,2.5,2190,2.0,2190,0,1999
1751,230000.0,3.0,2.0,1440,1.0,720,720,1942
1752,550000.0,4.0,2.5,2170,1.0,1460,710,1980
1753,1100000.0,4.0,3.75,2930,1.5,2130,800,1925
1754,193000.0,3.0,1.5,1180,1.0,1180,0,1960
1755,590000.0,4.0,4.25,2360,2.0,2360,0,1939
1756,712500.0,3.0,1.5,1660,1.0,1660,0,1956
1757,689800.0,3.0,2.75,2390,1.0,1390,1000,1942
1758,430000.0,3.0,2.0,1360,1.5,910,450,1924
1759,785200.0,3.0,2.25,1840,1.5,1540,300,1910
1760,474900.0,3.0,2.25,1800,1.0,1800,0,1976
1762,435000.0,3.0,1.75,2220,1.0,1110,1110,1988
1763,941500.0,5.0,3.5,3490,2.0,2460,1030,1980
1764,312000.0,4.0,2.5,1830,2.0,1830,0,2003
1765,835000.0,4.0,2.75,1550,1.5,1550,0,1930
1766,713250.0,3.0,2.0,2050,1.0,2050,0,1951
1767,440000.0,2.0,1.0,1230,1.0,1130,100,1906
1768,580135.0,4.0,2.5,3150,2.0,3150,0,2014
1769,575000.0,3.0,2.25,3800,1.0,3330,470,1976
1770,613000.0,3.0,2.5,1350,2.0,1350,0,1991
1771,235000.0,3.0,2.0,1530,1.0,1530,0,1970
1772,660000.0,3.0,2.5,2290,3.0,2290,0,1953
1773,280000.0,2.0,1.5,1480,1.0,1480,0,1940
1774,268000.0,3.0,1.75,1970,1.0,1970,0,1966
1775,235000.0,2.0,1.0,720,1.0,720,0,1947
1776,390000.0,3.0,2.0,1080,1.0,1080,0,1947
1777,654950.0,4.0,2.5,2790,2.0,2790,0,1987
1778,449500.0,5.0,2.75,2040,1.0,1200,840,1969
1779,150000.0,3.0,1.0,1320,1.0,1320,0,1959
1780,440000.0,3.0,2.25,1680,2.0,1680,0,1989
1781,710000.0,3.0,2.0,2140,1.0,1070,1070,1928
1782,420000.0,3.0,1.75,1660,1.0,1380,280,1981
1783,312000.0,3.0,2.25,1540,1.0,770,770,1954
1784,320000.0,3.0,2.0,1880,1.0,940,940,1952
1785,235000.0,3.0,1.0,1250,1.0,1250,0,1959
1786,437000.0,5.0,2.0,2120,1.5,2120,0,1913
1787,545000.0,3.0,1.75,1810,1.5,1810,0,1903
1788,640000.0,3.0,2.5,2370,2.0,2370,0,1993
1789,432000.0,3.0,2.5,1970,2.0,1970,0,2003
1790,548000.0,3.0,2.5,2110,2.0,2110,0,2001
1791,830000.0,3.0,3.0,2080,1.5,2080,0,2004
1793,409950.0,2.0,1.75,1370,1.0,1370,0,1944
1794,695000.0,4.0,2.5,2961,2.0,2961,0,1998
1795,562100.0,3.0,2.25,2090,2.0,2090,0,1983
1796,475000.0,3.0,2.5,2600,2.0,2600,0,1989
1797,425000.0,3.0,2.25,1870,1.0,1440,430,1978
1798,600000.0,4.0,2.5,2620,2.0,2620,0,1987
1799,770000.0,3.0,2.5,2430,2.0,2430,0,1987
1800,239000.0,3.0,1.75,1340,1.0,1340,0,1968
1801,295000.0,2.0,1.0,1170,1.0,1170,0,1963
1802,560000.0,3.0,1.75,2000,1.0,1400,600,1963
1803,613000.0,5.0,2.5,2070,1.0,1340,730,1967
1805,847000.0,5.0,1.0,2550,2.5,2550,0,1905
1806,206000.0,3.0,1.0,1060,1.0,1060,0,1962
1807,253000.0,2.0,1.75,1220,1.0,860,360,1921
1808,430000.0,4.0,2.25,1790,1.0,1110,680,1973
1809,605000.0,3.0,2.0,2060,1.0,1120,940,1947
1810,425000.0,2.0,2.5,1140,3.0,1140,0,2007
1811,720000.0,4.0,2.5,2870,2.0,2870,0,1986
1813,1298000.0,4.0,3.5,2790,1.5,2790,0,1985
1814,210000.0,3.0,1.0,1110,1.0,1110,0,1962
1815,234000.0,2.0,1.0,940,1.0,940,0,1952
1816,285000.0,3.0,1.75,2880,1.0,1580,1300,1958
1817,400000.0,3.0,1.5,1200,1.0,1200,0,1962
1818,718000.0,3.0,1.0,1030,1.0,1030,0,1952
1819,174500.0,2.0,2.5,1240,2.0,1240,0,1986
1820,222400.0,3.0,2.0,1200,1.0,1200,0,1995
1821,402500.0,3.0,3.25,2780,2.0,2780,0,2009
1822,250000.0,3.0,2.25,1765,2.0,1765,0,1996
1823,600000.0,4.0,2.5,1960,1.0,1290,670,1958
1824,930000.0,2.0,2.5,2680,1.0,2680,0,2006
1825,272500.0,3.0,2.0,1410,1.0,1410,0,1983
1826,363990.0,4.0,2.5,2240,2.0,2240,0,2014
1827,575000.0,4.0,2.75,3120,2.0,3120,0,2010
1828,400000.0,3.0,2.25,1450,2.0,1450,0,2009
1829,427874.0,3.0,3.0,2340,2.0,2340,0,2013
1830,309000.0,5.0,2.75,2481,2.0,2481,0,2014
1831,320000.0,3.0,3.25,1530,2.0,1140,390,2013
1832,390000.0,3.0,2.25,1250,1.0,1250,0,1942
1833,299000.0,1.0,0.75,560,1.0,560,0,1967
1834,375000.0,4.0,1.75,2200,1.0,1100,1100,1955
1835,240500.0,3.0,1.75,1460,1.0,990,470,1997
1836,320000.0,3.0,1.5,1650,1.0,1130,520,1978
1837,1270000.0,5.0,2.5,3200,1.0,2160,1040,1952
1838,658588.0,3.0,2.25,2560,2.0,2560,0,1986
1839,270000.0,3.0,2.25,2080,1.5,1550,530,2003
1840,327500.0,3.0,1.0,1070,1.0,1070,0,1989
1841,340000.0,3.0,1.75,2190,2.0,2190,0,1978
1842,200000.0,3.0,1.5,2060,1.5,2060,0,1903
1843,1025000.0,3.0,1.75,2640,1.0,1320,1320,1960
1844,275000.0,3.0,2.5,1720,1.0,1000,720,1983
1845,1126000.0,5.0,3.5,3880,2.0,2540,1340,1979
1846,280000.0,2.0,1.0,960,1.0,960,0,1942
1847,485000.0,3.0,2.5,2340,1.0,2340,0,1985
1849,865000.0,3.0,1.75,2090,2.0,1610,480,1947
1850,532000.0,3.0,2.5,1820,2.0,1820,0,1993
1851,364950.0,4.0,2.5,2310,2.0,2310,0,1978
1852,212500.0,3.0,1.0,920,1.0,920,0,1977
1853,135000.0,1.0,1.0,790,1.0,790,0,1942
1854,437000.0,2.0,1.75,1500,1.0,910,590,1942
1855,390000.0,3.0,1.0,1240,1.0,1240,0,1952
1856,760000.0,4.0,2.5,2730,2.0,2730,0,1986
1857,119500.0,3.0,1.0,1170,1.0,1170,0,1980
1859,837500.0,4.0,2.5,2700,2.0,2700,0,1994
1860,327500.0,4.0,1.75,1650,1.0,1650,0,1968
1861,175000.0,2.0,1.0,670,1.0,670,0,1919
1862,289950.0,3.0,2.0,1670,1.0,1670,0,1992
1863,400000.0,3.0,1.75,1530,1.0,1530,0,1986
1864,219950.0,3.0,2.25,1500,1.0,1150,350,1984
1865,161700.0,4.0,1.75,1720,1.0,1220,500,1974
1866,500000.0,5.0,3.0,2920,2.0,2920,0,2003
1867,465000.0,3.0,1.0,910,1.0,910,0,1948
1868,540000.0,3.0,1.0,1050,1.0,1050,0,1925
1869,525000.0,3.0,2.0,1540,1.0,1540,0,2004
1870,324950.0,3.0,1.0,1210,1.0,1210,0,1949
1871,565000.0,5.0,2.5,2650,1.0,1400,1250,1961
1872,760500.0,3.0,2.0,1990,1.0,1130,860,1912
1873,1100000.0,5.0,2.75,2660,1.0,1470,1190,1969
1875,453500.0,5.0,2.5,2300,1.0,1170,1130,1967
1877,275000.0,2.0,1.0,770,1.0,770,0,1948
1878,875000.0,4.0,2.75,3790,2.0,3790,0,1999
1879,335000.0,4.0,2.75,2540,1.0,1600,940,1979
1880,646000.0,4.0,2.25,2500,1.0,1600,900,1978
1881,392500.0,4.0,2.5,2150,2.0,2150,0,2005
1882,785000.0,3.0,1.75,1670,1.0,1670,0,1961
1883,470000.0,3.0,2.0,1800,1.0,1800,0,1956
1884,560000.0,3.0,2.5,2070,2.0,2070,0,1996
1885,519000.0,2.0,1.0,830,1.0,830,0,1920
1886,746000.0,3.0,2.25,2370,1.0,1650,720,1973
1887,317000.0,3.0,1.0,1010,1.0,1010,0,1959
1888,371000.0,3.0,1.5,1420,1.0,1420,0,1959
1889,250000.0,4.0,2.0,2120,1.5,2120,0,1960
1890,532000.0,4.0,1.75,2020,1.0,1430,590,1979
1891,499950.0,3.0,2.5,1520,2.0,1040,480,2007
1892,375000.0,2.0,1.0,820,1.0,820,0,1922
1893,640000.0,3.0,2.5,1690,2.5,1690,0,2007
1894,400000.0,3.0,2.0,2260,1.0,1130,1130,1986
1895,572000.0,3.0,2.25,1830,1.0,1290,540,1986
1896,310000.0,3.0,2.0,1350,1.0,1110,240,1995
1897,989000.0,5.0,3.5,3280,2.0,2440,840,2003
1898,685000.0,4.0,2.5,2770,2.0,2770,0,1989
1899,907500.0,4.0,2.5,2770,2.0,2770,0,1987
1900,427500.0,4.0,2.5,2460,2.0,2460,0,2003
1902,365000.0,2.0,1.0,1250,1.0,1250,0,1947
1903,250500.0,3.0,2.0,1710,2.0,1710,0,1988
1904,411715.0,3.0,1.75,1840,1.0,1040,800,1952
1905,415000.0,4.0,2.5,2000,2.0,2000,0,1999
1906,129000.0,1.0,1.0,650,1.0,650,0,1967
1907,489000.0,3.0,1.5,1020,1.0,920,100,1930
1908,170000.0,2.0,1.0,1500,1.0,1500,0,1950
1909,418500.0,3.0,2.5,2060,2.0,2060,0,2007
1910,261000.0,3.0,1.5,1810,1.0,950,860,1983
1912,355000.0,2.0,1.75,1650,1.0,950,700,1947
1913,742000.0,3.0,3.25,1540,3.0,1540,0,2011
1914,399950.0,3.0,1.5,2080,1.0,1190,890,1959
1915,791000.0,3.0,2.25,2430,2.0,1810,620,1989
1916,190000.0,5.0,2.0,1750,1.0,1750,0,1943
1917,229500.0,3.0,1.75,1770,1.0,1770,0,1968
1918,539000.0,3.0,2.5,1710,2.0,1570,140,2005
1919,549000.0,4.0,2.25,2740,2.0,2740,0,1991
1920,545000.0,5.0,2.5,2730,1.0,1660,1070,1958
1921,285000.0,3.0,2.5,2437,2.0,2437,0,2011
1922,648000.0,4.0,2.5,3290,2.0,3290,0,2008
1923,610000.0,4.0,3.5,2910,2.0,2910,0,2012
1924,767450.0,3.0,2.0,1630,1.0,1630,0,2006
1925,765000.0,4.0,3.0,4410,2.0,3400,1010,2006
1926,586500.0,3.0,2.5,1780,3.0,1600,180,2006
1927,520000.0,3.0,3.25,1540,2.0,1540,0,2011
1928,455000.0,3.0,1.75,1420,3.0,1420,0,2006
1929,653000.0,3.0,2.5,2680,1.0,1610,1070,1979
1930,279950.0,3.0,2.0,1750,1.0,1350,400,1961
1931,449950.0,3.0,2.5,2170,2.0,2170,0,2003
1932,565000.0,3.0,2.75,2390,1.0,1360,1030,1977
1933,620000.0,4.0,2.25,2400,1.5,1460,940,1929
1934,269000.0,3.0,1.0,1690,1.0,1020,670,1967
1935,875000.0,3.0,3.5,3250,2.0,2500,750,2001
1937,425000.0,4.0,2.75,2440,2.0,2440,0,1957
1938,647500.0,3.0,1.75,1290,1.0,1290,0,1916
1939,450000.0,4.0,1.0,2000,1.5,1250,750,1916
1940,440000.0,3.0,1.0,1050,1.0,1050,0,1900
1941,445000.0,4.0,2.5,2340,2.0,2340,0,2008
1942,530000.0,4.0,2.25,2210,2.0,2210,0,1968
1943,875000.0,5.0,2.5,2920,2.0,2320,600,1906
1944,685000.0,3.0,2.75,3150,2.0,3000,150,1990
1945,798000.0,3.0,3.5,3590,2.0,3590,0,1999
1946,297500.0,4.0,2.5,1910,2.0,1910,0,2005
1947,749950.0,4.0,2.75,3110,2.0,3110,0,1983
1948,495000.0,5.0,3.0,2440,1.0,1450,990,2006
1949,540000.0,4.0,2.25,1330,1.5,1330,0,1962
1950,395000.0,3.0,1.75,1460,1.0,1460,0,1961
1953,214100.0,2.0,2.5,1150,2.0,1150,0,2004
1954,210000.0,4.0,1.5,1920,1.0,1370,550,1959
1955,499500.0,3.0,2.5,2520,1.5,2520,0,1988
1956,546000.0,2.0,1.0,970,1.0,970,0,1924
1957,292000.0,5.0,2.5,2490,1.0,1490,1000,1989
1958,289000.0,3.0,2.0,1680,1.0,1680,0,1993
1959,240000.0,3.0,1.0,1150,1.0,1150,0,1957
1960,395000.0,4.0,3.0,1980,1.0,1160,820,1983
1961,795000.0,4.0,2.25,2070,1.0,1700,370,1967
1963,725000.0,4.0,2.75,2420,1.0,1530,890,1977
1964,335000.0,4.0,2.5,2610,2.0,2610,0,2009
1965,492000.0,4.0,3.75,2810,2.0,2070,740,1994
1966,250000.0,3.0,2.5,1510,1.0,1030,480,1976
1967,700000.0,3.0,1.75,1910,1.0,1080,830,1959
1968,545000.0,3.0,1.75,1700,1.5,1700,0,1931
1969,555000.0,4.0,2.75,2020,1.0,1420,600,1976
1970,640000.0,3.0,1.75,2340,1.0,1170,1170,1917
1971,390000.0,3.0,2.0,1463,3.0,1463,0,2003
1972,466500.0,3.0,1.0,1430,1.0,950,480,1945
1973,372500.0,3.0,1.5,1180,1.0,800,380,1981
1975,255000.0,3.0,2.5,1610,2.0,1610,0,1994
1976,466800.0,3.0,2.5,1480,2.0,1480,0,1996
1977,749000.0,3.0,2.5,2670,2.0,2670,0,1987
1978,610000.0,4.0,1.75,1830,2.0,1230,600,1990
1979,356000.0,2.0,1.0,920,1.0,920,0,1914
1980,165000.0,3.0,1.0,1150,1.0,1150,0,1908
1981,229000.0,2.0,1.0,1190,1.0,830,360,1941
1982,530000.0,4.0,3.25,4160,2.0,2760,1400,1973
1983,499950.0,3.0,2.5,2370,2.0,2370,0,2001
1984,619000.0,4.0,1.75,1660,1.5,1660,0,1926
1985,547000.0,3.0,2.5,1480,1.0,1480,0,1968
1986,359800.0,4.0,2.5,2390,2.0,2390,0,1999
1987,499000.0,3.0,3.5,1690,2.0,1360,330,2008
1988,189000.0,3.0,1.0,1010,1.0,1010,0,1958
1989,799000.0,4.0,3.5,3500,2.0,2500,1000,1994
1990,257000.0,4.0,2.75,2330,1.0,1800,530,1990
1991,270000.0,3.0,1.5,1890,1.0,1090,800,1957
1992,453500.0,4.0,1.75,2000,1.0,1300,700,1959
1993,237000.0,3.0,1.0,1130,1.0,1130,0,1954
1994,456000.0,4.0,1.75,1670,1.0,1670,0,1947
1995,355500.0,3.0,2.5,2600,2.0,2600,0,2004
1996,299950.0,4.0,1.75,1560,1.0,1560,0,1965
1997,335000.0,3.0,2.0,1170,1.0,1170,0,1919
1998,268500.0,4.0,2.5,2100,2.0,2100,0,2006
1999,385000.0,3.0,2.25,1710,1.0,1210,500,1978
2000,376000.0,4.0,2.75,2420,2.0,2420,0,2005
2001,605004.0,4.0,2.0,1370,2.0,1370,0,1951
2002,886000.0,4.0,2.0,2660,1.5,1480,1180,1923
2003,560000.0,4.0,2.5,2260,2.0,2260,0,2003
2004,343000.0,4.0,2.5,2070,2.0,2070,0,2004
2006,270000.0,3.0,1.0,1500,1.0,1500,0,1968
2007,411605.0,4.0,2.5,2658,2.0,2658,0,2014
2008,550000.0,4.0,2.5,2700,2.0,2700,0,2007
2009,465000.0,3.0,2.25,1530,2.0,1050,480,2014
2010,584000.0,3.0,2.5,1480,2.0,1280,200,2007
2011,275000.0,3.0,3.0,1390,2.0,1140,250,2006
2012,324500.0,3.0,2.5,1660,2.0,1660,0,2009
2013,700000.0,3.0,2.5,2050,2.0,2050,0,2011
2014,385200.0,4.0,1.0,1550,1.5,1550,0,1954
2015,270000.0,4.0,2.25,1900,1.0,1900,0,1975
2016,735000.0,4.0,2.5,2820,2.0,2050,770,2013
2017,389250.0,2.0,1.5,1490,1.0,930,560,1956
2018,315000.0,3.0,1.5,1750,1.0,1150,600,1954
2019,545000.0,4.0,2.5,2040,2.0,2040,0,1990
2020,550000.0,3.0,1.5,1900,1.5,1640,260,1926
2021,415000.0,3.0,1.75,1910,1.0,1340,570,1977
2022,387500.0,3.0,1.0,1560,1.0,1560,0,1953
2023,432000.0,3.0,1.75,1470,1.0,1070,400,1939
2024,402000.0,3.0,2.5,2700,1.0,1350,1350,1959
2025,1035000.0,4.0,3.25,3450,2.0,2430,1020,1960
2026,294700.0,3.0,2.0,1970,1.0,1300,670,1967
2027,744000.0,3.0,2.5,2670,2.0,2670,0,1986
2028,715000.0,3.0,2.5,2550,2.0,2550,0,1990
2029,500000.0,4.0,1.0,1720,1.5,1720,0,1904
2030,1300000.0,4.0,4.0,4270,2.0,3180,1090,2004
2031,1150000.0,3.0,1.5,2170,1.0,1130,1040,1979
2032,650000.0,4.0,2.5,2840,2.0,2840,0,1990
2033,435000.0,4.0,2.75,3270,2.0,2720,550,1983
2034,510000.0,3.0,1.75,1480,1.0,1480,0,1974
2035,525000.0,5.0,2.75,2440,1.0,1240,1200,1972
2036,920000.0,4.0,2.75,2880,1.5,1710,1170,1928
2037,200000.0,2.0,1.0,1730,1.0,1380,350,1962
2038,435000.0,2.0,1.0,1260,1.5,1260,0,1926
2039,809950.0,4.0,2.0,2230,1.5,2230,0,1959
2040,1370000.0,2.0,2.25,2460,1.5,1930,530,1936
2041,455000.0,4.0,1.75,2050,1.0,1250,800,1959
2042,471000.0,3.0,2.5,2030,2.0,1720,310,2001
2043,253500.0,2.0,1.0,810,1.0,810,0,1948
2044,185000.0,3.0,1.0,1840,1.0,920,920,1953
2045,535500.0,3.0,1.5,1730,2.0,1730,0,1983
2046,835000.0,2.0,2.0,2280,1.0,2280,0,2002
2047,589500.0,4.0,2.5,2630,2.0,2630,0,2008
2048,680000.0,3.0,2.25,2270,1.0,1820,450,1975
2049,360000.0,3.0,1.75,1020,1.5,1020,0,1953
2050,595000.0,4.0,2.5,1990,2.0,1680,310,2005
2051,300000.0,4.0,2.5,2680,2.0,2680,0,1999
2052,660000.0,3.0,1.75,1980,1.5,1140,840,1926
2053,570000.0,3.0,2.5,2400,2.0,2400,0,1993
2054,285000.0,2.0,1.0,780,1.0,780,0,1943
2055,435000.0,3.0,2.0,980,1.0,980,0,1940
2056,160000.0,3.0,1.0,1210,1.0,1210,0,1918
2058,450000.0,3.0,2.5,1480,2.0,1480,0,2005
2059,510000.0,4.0,1.5,1320,1.0,1320,0,1954
2061,1280000.0,4.0,3.5,3010,2.0,2370,640,1999
2062,539000.0,3.0,2.0,2260,1.0,1780,480,1985
2063,407193.0,4.0,2.0,1880,2.0,1880,0,1978
2064,320000.0,3.0,1.75,1370,1.0,1370,0,1983
2065,739000.0,4.0,3.0,2720,2.0,1800,920,1919
2066,452000.0,2.0,1.75,1740,1.0,990,750,1946
2067,600000.0,4.0,2.5,2560,2.0,2560,0,2001
2068,279000.0,5.0,2.5,2690,2.0,2690,0,2012
2069,895000.0,4.0,3.0,3240,2.0,3240,0,2013
2070,585000.0,4.0,2.5,2430,2.0,2430,0,2008
2071,405000.0,2.0,2.0,1405,2.0,1140,265,2007
2072,837219.0,5.0,2.75,3030,2.0,3030,0,2014
2074,490000.0,3.0,3.0,1730,3.0,1730,0,1985
2076,462000.0,4.0,2.5,3070,2.0,3070,0,2006
2077,540000.0,4.0,2.5,1780,2.0,1780,0,1994
2078,260000.0,4.0,2.5,1811,2.0,1811,0,2007
2079,510000.0,4.0,2.25,2450,2.0,2450,0,1976
2080,567500.0,3.0,2.5,2300,2.0,2300,0,2001
2081,445000.0,2.0,1.0,1440,1.0,960,480,1915
2082,684680.0,4.0,2.25,2370,2.0,2370,0,1979
2084,455000.0,3.0,1.0,1300,1.5,1300,0,1927
2085,540000.0,5.0,3.0,2870,2.0,2090,780,2007
2086,530000.0,3.0,2.75,3400,2.0,2470,930,2009
2087,410000.0,3.0,1.0,1410,1.0,910,500,1956
2088,450000.0,3.0,1.75,1640,1.0,1110,530,1940
2089,609900.0,4.0,2.5,3190,2.0,3190,0,2006
2090,648000.0,4.0,2.5,2380,2.0,2380,0,1992
2091,550000.0,3.0,2.5,2260,2.0,2260,0,2005
2092,347000.0,3.0,1.75,1240,1.0,1240,0,1978
2094,1339000.0,4.0,2.5,4250,2.0,3260,990,1972
2095,288350.0,3.0,1.5,1860,1.0,1200,660,1963
2096,1150000.0,3.0,2.5,2850,1.0,1730,1120,1954
2097,525000.0,3.0,3.0,2470,2.0,2470,0,1980
2098,250250.0,3.0,2.25,2210,2.0,2210,0,1969
2099,341000.0,4.0,1.75,1920,1.0,1500,420,1975
2100,700000.0,4.0,3.0,3150,2.0,3150,0,2000
2101,390000.0,4.0,1.75,2700,1.5,2700,0,1968
2102,539950.0,3.0,2.25,2190,1.0,1240,950,1963
2103,552000.0,2.0,2.5,1380,3.0,1380,0,2006
2104,250000.0,5.0,1.5,2520,1.5,1510,1010,1928
2105,502000.0,3.0,1.75,1300,1.0,1300,0,1963
2106,480000.0,4.0,1.75,2220,2.0,2220,0,1964
2107,378500.0,2.0,1.0,730,1.0,730,0,1946
2108,1350000.0,4.0,3.25,3300,2.0,3300,0,1985
2110,605000.0,3.0,2.5,2670,2.0,2670,0,1981
2111,307550.0,4.0,2.5,1980,2.0,1980,0,2003
2112,304700.0,2.0,1.0,740,1.0,740,0,1949
2113,568000.0,3.0,1.75,2050,1.0,1070,980,1977
2114,385000.0,3.0,1.75,1230,1.0,1230,0,1987
2115,345000.0,3.0,2.5,1210,3.0,1210,0,2008
2116,435000.0,3.0,2.25,1890,1.0,1230,660,1973
2117,579000.0,2.0,2.0,1870,1.0,1870,0,2003
2118,236000.0,3.0,1.75,1330,1.0,1330,0,1998
2119,305100.0,3.0,2.0,1590,1.0,1590,0,1974
2120,368000.0,3.0,1.75,1710,1.0,1710,0,1958
2121,255000.0,2.0,1.0,1200,1.0,1200,0,1917
2122,400000.0,2.0,1.0,1140,1.0,1140,0,1942
2123,440000.0,3.0,1.75,2240,1.0,1120,1120,1948
2124,417000.0,2.0,1.0,920,1.0,920,0,1919
2125,435000.0,2.0,1.0,800,1.0,800,0,1906
2126,475000.0,4.0,2.75,1980,1.0,1980,0,1952
2127,563500.0,4.0,2.5,2800,2.0,2800,0,2001
2128,285000.0,3.0,2.25,1680,2.0,1680,0,1987
2129,471000.0,4.0,2.5,2330,2.0,2330,0,1998
2130,500000.0,4.0,1.75,2240,1.5,2240,0,1965
2131,640000.0,3.0,2.5,2140,2.0,2140,0,1991
2132,442500.0,4.0,2.5,2170,2.0,2170,0,1992
2133,213400.0,3.0,1.5,1150,1.0,1150,0,1963
2134,831000.0,4.0,2.5,2030,1.5,1630,400,1926
2135,325000.0,3.0,2.0,1350,1.0,1350,0,1986
2136,425000.0,2.0,1.0,910,1.0,910,0,1905
2137,550000.0,4.0,2.5,2700,1.0,1440,1260,1968
2138,599950.0,4.0,3.5,3730,2.0,2440,1290,1991
2139,1225000.0,4.0,2.5,2740,2.0,2740,0,1984
2140,750000.0,4.0,3.25,2050,2.0,1370,680,1987
2141,290000.0,4.0,3.0,2390,2.0,2390,0,1974
2142,270000.0,4.0,2.75,1990,1.0,1270,720,1999
2143,229950.0,4.0,1.75,1300,1.0,1300,0,1969
2144,234999.0,3.0,1.0,1330,1.0,1330,0,1948
2145,265000.0,2.0,1.0,1000,1.0,1000,0,1960
2146,367300.0,4.0,2.75,2190,2.0,2190,0,1993
2147,550000.0,3.0,1.75,1380,1.5,1380,0,1900
2148,743700.0,4.0,2.5,2610,2.0,2610,0,1988
2149,352750.0,2.0,1.75,1060,2.0,960,100,2008
2150,403950.0,2.0,1.0,710,2.0,710,0,1943
2151,980000.0,4.0,2.5,2730,1.5,2230,500,1909
2152,585000.0,4.0,1.75,2470,2.0,2470,0,1937
2153,554000.0,3.0,1.75,1760,1.0,1760,0,1977
2154,546000.0,3.0,2.5,1530,2.0,1530,0,1998
2155,280000.0,2.0,1.75,1610,1.5,1610,0,1948
2156,212500.0,2.0,2.0,1030,1.0,1030,0,1938
2157,739000.0,4.0,2.5,2800,2.0,2800,0,1999
2158,428000.0,3.0,2.0,1310,1.0,780,530,1986
2159,965000.0,4.0,2.25,3160,1.0,3160,0,1981
2160,364900.0,3.0,3.0,2500,2.0,2500,0,1997
2161,559000.0,3.0,1.5,2070,1.0,1140,930,1948
2162,213000.0,4.0,1.75,1980,1.0,1480,500,1978
2163,620000.0,3.0,2.5,2590,2.0,2590,0,2004
2164,240000.0,4.0,1.0,1910,1.5,1910,0,1934
2165,852500.0,3.0,2.5,2630,1.0,1580,1050,1967
2166,600000.0,3.0,2.5,2630,2.0,2630,0,2004
2167,410000.0,3.0,2.5,1960,2.0,1960,0,2006
2168,328000.0,3.0,1.75,1440,2.0,1440,0,1977
2169,625000.0,3.0,1.75,2210,1.0,1390,820,1958
2170,649950.0,4.0,2.5,2350,2.0,2350,0,1994
2171,235000.0,3.0,1.0,1590,1.5,1590,0,1944
2172,489000.0,3.0,3.5,1500,2.0,1240,260,2004
2173,536000.0,3.0,2.5,1900,2.0,1900,0,2005
2174,400000.0,4.0,3.5,2370,2.5,2370,0,2013
2175,398000.0,3.0,2.5,1720,2.0,1240,480,2004
2176,379000.0,4.0,1.5,2020,1.0,2020,0,1960
2177,345000.0,2.0,1.5,1340,2.0,1120,220,2008
2178,365000.0,3.0,2.5,1800,2.0,1800,0,2011
2179,315000.0,3.0,2.5,1480,2.0,1150,330,2010
2180,571000.0,4.0,2.0,2750,1.5,2250,500,1916
2181,1025000.0,5.0,4.0,3760,2.0,3760,0,1983
2182,695000.0,3.0,2.75,2540,2.0,2540,0,2005
2183,225000.0,3.0,1.75,1760,1.0,920,840,1979
2184,740000.0,3.0,2.5,3000,2.0,3000,0,1995
2185,315000.0,4.0,2.5,1930,2.0,1930,0,1992
2186,1230000.0,4.0,2.5,3040,2.0,3040,0,2001
2187,420000.0,2.0,1.0,860,1.0,860,0,1916
2188,310000.0,3.0,1.75,1420,1.0,1100,320,1984
2189,700000.0,3.0,2.0,2080,1.0,1160,920,1954
2190,269000.0,3.0,2.5,1560,2.0,1560,0,2003
2191,369990.0,4.0,2.5,1960,2.0,1960,0,2002
2192,800000.0,3.0,2.25,1620,2.0,1620,0,1926
2195,440000.0,3.0,1.5,1290,3.0,1290,0,2000
2196,435000.0,5.0,2.25,1970,1.0,1450,520,1986
2197,345000.0,3.0,1.75,1540,1.0,920,620,1955
2198,558000.0,4.0,2.0,2180,1.0,1020,1160,1900
2199,475000.0,2.0,1.75,1490,1.0,1490,0,1983
2200,490000.0,3.0,2.0,2220,2.0,1640,580,1980
2201,335000.0,3.0,1.75,2430,1.0,1410,1020,1978
2202,350000.0,2.0,0.75,1392,1.5,1392,0,1978
2203,100000.0,4.0,1.0,1120,1.0,860,260,1939
2204,417500.0,4.0,1.0,1390,1.5,1390,0,1941
2205,253000.0,3.0,1.75,2040,1.0,1020,1020,1962
2206,1240000.0,5.0,3.0,2830,2.0,2460,370,1923
2207,490000.0,4.0,2.5,3020,2.0,3020,0,1994
2208,470000.0,3.0,1.75,2290,1.0,1620,670,1965
2209,483300.0,4.0,2.0,1210,1.0,1210,0,1955
2210,659000.0,3.0,2.5,2510,2.0,2510,0,1996
2211,480000.0,4.0,1.75,2320,1.0,1140,1180,1910
2212,165000.0,3.0,1.0,970,1.0,970,0,1965
2213,659500.0,3.0,1.75,1820,1.0,1620,200,1957
2214,219900.0,3.0,1.0,970,1.0,970,0,1967
2215,315000.0,2.0,1.0,1740,1.0,950,790,1924
2216,250000.0,3.0,1.75,1590,1.0,1130,460,1984
2217,268000.0,2.0,1.0,1380,1.0,870,510,1943
2218,380000.0,4.0,1.5,1680,1.0,1130,550,1959
2219,499000.0,2.0,1.0,1220,1.0,920,300,1926
2220,285000.0,2.0,2.0,1651,1.0,1651,0,1946
2221,183000.0,3.0,1.75,1330,1.0,1330,0,1973
2222,1070000.0,3.0,3.0,2940,2.0,2230,710,1988
2223,429000.0,3.0,3.25,1410,3.0,1410,0,2005
2224,403000.0,2.0,1.0,1100,1.0,1100,0,1926
2225,375500.0,3.0,1.5,1530,1.0,1530,0,1975
2227,516200.0,3.0,2.0,2110,1.0,1080,1030,1919
2228,385000.0,4.0,1.75,1720,1.0,860,860,1971
2229,515000.0,3.0,2.5,1800,2.0,1800,0,1996
2230,375000.0,4.0,2.5,2210,2.0,2210,0,1999
2231,650000.0,4.0,2.25,2560,2.0,2560,0,1973
2232,306888.0,2.0,1.5,1010,2.0,1010,0,1981
2233,870000.0,4.0,2.5,3340,2.0,2470,870,1998
2234,310000.0,4.0,1.0,1740,1.5,1740,0,1965
2235,251750.0,3.0,2.0,1320,1.0,1320,0,1975
2236,366000.0,3.0,1.75,1520,1.0,1520,0,1976
2237,429950.0,3.0,1.5,2010,1.0,1570,440,1951
2238,710000.0,3.0,3.5,2440,2.0,1990,450,2000
2239,895000.0,5.0,2.5,2550,1.0,1610,940,1953
2240,149500.0,3.0,1.0,1010,1.0,1010,0,1959
2241,310000.0,3.0,2.5,1780,1.0,1230,550,1990
2242,555000.0,3.0,2.0,2180,1.5,1680,500,1930
2243,750000.0,5.0,3.25,2750,2.0,2150,600,1937
2244,745000.0,4.0,3.25,3490,2.0,3490,0,2006
2245,695000.0,3.0,2.5,2550,2.0,2550,0,2001
2246,433000.0,3.0,1.75,1870,1.0,1270,600,1959
2247,307000.0,4.0,1.0,1150,1.5,1150,0,1947
2248,655275.0,3.0,1.75,2050,1.0,1460,590,1962
2249,392000.0,4.0,2.75,1940,2.0,1940,0,1990
2250,1180000.0,5.0,3.75,3630,1.5,2470,1160,2004
2251,359950.0,3.0,1.75,1890,2.0,1890,0,1952
2252,360000.0,4.0,2.0,1630,1.0,1630,0,1968
2253,566000.0,4.0,1.75,2440,1.0,1340,1100,1954
2254,700000.0,5.0,2.75,3100,2.0,3100,0,1950
2255,415000.0,3.0,2.5,2090,2.0,2090,0,2000
2256,199500.0,3.0,1.0,920,1.0,920,0,1962
2257,749000.0,3.0,1.0,1580,1.5,1580,0,1926
2258,680000.0,3.0,1.75,1760,1.0,1460,300,1960
2259,400000.0,4.0,2.5,2530,1.0,1440,1090,1978
2260,608000.0,4.0,2.75,2490,1.0,1400,1090,1983
2262,480000.0,5.0,2.5,2732,1.0,1870,862,1975
2263,1059500.0,5.0,3.25,3230,2.0,2480,750,2014
2265,695000.0,4.0,3.5,3510,2.0,3510,0,2001
2266,899900.0,4.0,2.5,2580,2.0,2580,0,2013
2267,499950.0,2.0,2.25,1060,2.0,940,120,2005
2268,533112.0,4.0,2.75,2790,2.0,2790,0,2013
2269,303210.0,4.0,2.5,2009,2.0,2009,0,2014
2270,525000.0,5.0,2.75,2880,2.0,2880,0,2006
2271,399950.0,2.0,1.0,710,2.0,710,0,1943
2272,850830.0,3.0,2.5,2070,1.5,1270,800,1910
2273,371500.0,3.0,2.0,1370,1.0,1370,0,1964
2274,522000.0,3.0,1.75,1730,1.0,1400,330,1980
2275,588000.0,4.0,2.0,1680,1.0,980,700,1950
2276,276900.0,2.0,1.0,1350,1.0,1350,0,1952
2277,248000.0,5.0,1.5,1510,1.0,1510,0,1959
2278,280000.0,3.0,2.5,1860,2.0,1860,0,1989
2281,290300.0,2.0,1.0,860,1.0,860,0,1931
2282,527000.0,2.0,1.75,1640,1.0,840,800,1921
2283,487028.0,2.0,1.5,1295,2.0,1105,190,2007
2284,325000.0,3.0,1.75,1790,1.0,1130,660,1978
2285,799000.0,3.0,1.5,2210,1.5,2210,0,1916
2287,354000.0,3.0,1.0,940,1.0,940,0,1965
2288,262500.0,3.0,1.5,1160,1.0,1160,0,1962
2289,560200.0,3.0,2.5,1990,2.0,1990,0,2004
2290,220000.0,3.0,1.0,1050,1.0,1050,0,1942
2291,650000.0,2.0,1.0,1030,1.0,1030,0,1928
2292,435000.0,3.0,2.5,1420,3.0,1420,0,2004
2293,800000.0,4.0,3.75,2690,2.0,2120,570,1909
2294,1010000.0,4.0,2.5,3760,2.0,3760,0,1987
2295,200000.0,2.0,1.0,700,1.0,700,0,1953
2296,295000.0,5.0,3.5,2100,2.0,1410,690,1999
2297,580379.0,4.0,2.75,2240,1.5,2240,0,1976
2298,875000.0,4.0,2.5,3470,2.0,3470,0,1995
2299,515000.0,3.0,2.5,3370,2.0,3200,170,1951
2300,599000.0,4.0,2.5,2790,2.0,2790,0,1989
2301,285000.0,3.0,2.5,1870,2.0,1870,0,2005
2302,290000.0,3.0,1.75,1520,1.0,1520,0,1968
2303,355000.0,1.0,1.75,750,1.0,550,200,1946
2304,381000.0,3.0,1.5,1460,1.0,1460,0,1954
2305,571000.0,3.0,2.5,2600,2.0,2600,0,1988
2306,852600.0,4.0,2.5,3320,2.0,2650,670,1977
2307,1085000.0,5.0,2.5,2340,2.0,2340,0,1922
2308,371000.0,3.0,1.0,890,1.0,890,0,1951
2309,514000.0,3.0,1.75,1720,1.0,1220,500,1986
2310,386000.0,3.0,1.5,1270,2.0,1080,190,2004
2311,464000.0,4.0,2.5,2180,2.0,2180,0,1989
2312,335000.0,4.0,2.25,2030,1.0,1230,800,1963
2313,740000.0,4.0,2.75,2490,2.0,1490,1000,1979
2314,465000.0,4.0,1.75,1470,1.0,980,490,1955
2315,700000.0,3.0,2.75,2500,1.0,1390,1110,1948
2317,350000.0,3.0,3.25,1460,2.0,1130,330,2006
2318,148000.0,1.0,1.0,620,1.0,620,0,1939
2319,530000.0,3.0,1.75,1550,1.0,1050,500,1927
2320,349000.0,3.0,2.5,1430,3.0,1430,0,2002
2321,240000.0,3.0,1.5,1360,1.5,1360,0,1984
2322,330000.0,3.0,2.5,2210,2.0,2210,0,1989
2323,735000.0,4.0,1.75,2460,1.5,1450,1010,1909
2324,545000.0,3.0,2.5,2180,1.0,1850,330,1979
2325,214950.0,3.0,1.75,1570,1.0,1310,260,1977
2327,476000.0,3.0,1.0,1140,1.5,1140,0,1908
2329,110000.0,2.0,1.0,800,1.0,800,0,1927
2330,292000.0,4.0,2.75,2414,2.0,2414,0,2006
2331,317000.0,3.0,1.0,1160,1.0,1160,0,1952
2332,455000.0,4.0,2.5,3170,2.0,3170,0,2001
2334,460000.0,3.0,2.0,2060,1.0,1030,1030,1929
2335,405000.0,3.0,2.0,1640,1.0,1640,0,1948
2336,333000.0,2.0,1.0,720,1.0,720,0,1942
2337,427000.0,4.0,1.0,1860,1.5,1860,0,1901
2338,742000.0,4.0,2.5,2810,2.0,2810,0,1997
2339,465000.0,4.0,2.5,2090,1.0,1320,770,1965
2340,809950.0,4.0,2.5,3280,2.0,3280,0,2001
2341,619400.0,4.0,2.0,2090,1.5,1790,300,1927
2342,762400.0,3.0,1.75,2430,1.0,1230,1200,1949
2343,535000.0,5.0,2.25,2520,2.0,2520,0,1978
2344,881000.0,5.0,3.0,2510,1.5,1590,920,1925
2345,813000.0,4.0,2.75,3370,1.0,1920,1450,1948
2346,234000.0,3.0,2.0,1640,1.5,1640,0,1910
2347,308900.0,3.0,2.5,2250,2.0,2250,0,1994
2348,450000.0,4.0,2.5,2300,1.0,2300,0,1955
2349,547500.0,3.0,3.5,1650,3.0,1650,0,2010
2350,399950.0,2.0,1.0,710,2.0,710,0,1943
2351,516000.0,4.0,3.5,2550,2.0,2550,0,2007
2352,250000.0,2.0,1.5,982,2.0,806,176,2006
2353,475000.0,3.0,2.25,1630,2.0,1630,0,2005
2354,415000.0,4.0,2.5,2550,2.0,2550,0,2009
2355,545000.0,2.0,1.25,1240,2.0,1240,0,2014
2356,329950.0,3.0,2.5,2456,2.0,2456,0,2012
2358,784000.0,3.0,3.5,3950,1.5,2460,1490,1989
2359,610750.0,4.0,2.25,2180,2.0,2180,0,1984
2360,578000.0,4.0,2.5,3140,1.0,1770,1370,1966
2362,501000.0,3.0,1.75,1970,1.0,1370,600,1976
2363,465250.0,5.0,2.0,1940,1.5,1940,0,1957
2366,315000.0,2.0,1.0,970,1.0,970,0,1908
2367,900000.0,4.0,2.25,2460,1.0,2460,0,1957
2368,789500.0,4.0,2.5,3010,2.0,3010,0,2005
2369,678500.0,3.0,2.0,2460,1.0,1370,1090,1952
2370,342500.0,3.0,2.0,2080,1.0,2080,0,2002
2371,860000.0,4.0,3.25,3960,2.0,3960,0,2005
2372,306000.0,4.0,2.5,2490,2.0,2490,0,2001
2373,580000.0,5.0,2.0,2060,2.0,2060,0,1903
2374,405000.0,3.0,1.0,1330,1.0,900,430,1984
2375,510000.0,3.0,1.75,1600,1.0,1600,0,1967
2376,173000.0,2.0,1.0,820,1.0,820,0,1965
2377,210000.0,4.0,1.75,1200,1.0,1200,0,1968
2378,445000.0,3.0,1.0,1050,1.0,910,140,1947
2379,585000.0,3.0,2.5,1910,2.5,1530,380,2007
2380,381000.0,3.0,1.75,1800,1.0,900,900,1950
2381,890000.0,3.0,2.25,2060,1.0,2060,0,1966
2382,235000.0,3.0,1.75,1840,1.0,1500,340,1985
2383,480000.0,3.0,2.5,1250,3.0,1250,0,2005
2384,575000.0,2.0,1.0,1510,1.5,1310,200,1935
2385,350000.0,4.0,2.25,2300,1.5,1340,960,1904
2386,259000.0,4.0,1.5,1490,2.0,1490,0,1966
2387,599000.0,5.0,2.75,2820,1.0,1450,1370,1967
2388,210000.0,4.0,1.5,1130,1.0,1130,0,1970
2389,1184000.0,4.0,2.5,3200,1.5,1860,1340,1948
2390,545000.0,3.0,1.0,1510,1.5,1510,0,1909
2391,299995.0,3.0,2.5,1970,2.0,1970,0,1988
2392,440000.0,3.0,1.0,1210,1.5,1210,0,1910
2393,699000.0,4.0,2.5,3280,2.0,3280,0,1996
2394,795000.0,3.0,2.0,2420,1.0,1500,920,1979
2395,445000.0,5.0,1.75,2460,1.5,1340,1120,1911
2396,397990.0,3.0,1.0,1180,1.0,1180,0,1948
2397,706000.0,3.0,2.75,1900,1.0,1410,490,1942
2398,363000.0,3.0,3.25,1651,2.0,1341,310,2008
2399,850000.0,4.0,2.25,2130,2.0,2130,0,1972
2400,620000.0,2.0,1.0,1430,1.5,1300,130,1929
2402,333000.0,4.0,2.5,1910,1.0,1910,0,1963
2403,743000.0,3.0,1.75,2110,1.0,2110,0,1961
2404,448000.0,2.0,1.5,1630,1.0,890,740,1940
2405,485000.0,4.0,2.5,2470,2.0,2470,0,1989
2406,489950.0,4.0,2.25,2640,1.0,2640,0,1986
2407,498500.0,5.0,2.75,2990,2.0,2990,0,1996
2408,531000.0,3.0,2.5,2120,2.0,2120,0,1988
2409,670000.0,3.0,2.5,2050,1.0,1730,320,1956
2410,310000.0,5.0,3.0,1880,1.0,1100,780,1997
2411,835000.0,3.0,3.0,2790,2.0,1600,1190,1977
2413,495000.0,4.0,2.5,2140,2.0,2140,0,2003
2414,495000.0,3.0,2.0,1769,1.0,1769,0,1955
2415,440000.0,3.0,1.0,1710,1.5,1200,510,1926
2416,280000.0,1.0,0.75,420,1.0,420,0,1922
2417,1070000.0,4.0,2.5,3270,2.0,3270,0,1989
2418,1034500.0,4.0,2.5,2370,2.0,2370,0,2003
2419,248000.0,4.0,2.5,1770,2.0,1770,0,2003
2420,294000.0,4.0,2.5,2210,1.0,1490,720,1990
2421,561000.0,3.0,2.25,1710,2.0,1710,0,2004
2422,656500.0,4.0,2.0,2710,1.0,1460,1250,1919
2423,660000.0,3.0,3.0,2340,2.0,2160,180,1925
2424,370000.0,2.0,1.0,1220,1.0,1220,0,1947
2425,349950.0,3.0,1.0,1060,1.0,1060,0,1966
2426,223000.0,2.0,1.0,910,1.0,910,0,1957
2427,560000.0,4.0,1.75,1880,1.5,1090,790,1944
2428,594000.0,4.0,1.75,1870,2.0,1200,670,1937
2429,600000.0,3.0,2.25,1480,2.0,1480,0,1914
2430,315000.0,3.0,2.5,1880,2.0,1880,0,1993
2431,430000.0,4.0,1.75,1890,1.0,1110,780,1947
2432,440000.0,3.0,2.75,1560,1.0,1030,530,1972
2433,312500.0,2.0,1.5,1070,2.0,1070,0,1999
2435,300000.0,3.0,3.25,1470,2.0,1180,290,2008
2436,680000.0,3.0,2.5,2570,2.5,2570,0,2007
2437,336750.0,2.0,2.25,1170,2.0,1170,0,2009
2438,822500.0,5.0,3.5,2320,2.0,1720,600,1926
2439,589000.0,4.0,3.0,2440,2.0,2440,0,1961
2441,210000.0,2.0,1.75,1440,1.0,1440,0,1978
2442,206135.0,3.0,1.0,1340,1.0,1340,0,1978
2444,285000.0,3.0,1.75,1840,1.0,920,920,1905
2445,230000.0,2.0,1.0,930,1.0,930,0,1986
2447,350000.0,3.0,1.75,1820,1.0,1230,590,1976
2448,304000.0,3.0,1.0,1280,1.5,1280,0,1947
2449,370000.0,2.0,1.0,900,1.0,900,0,1951
2450,810000.0,3.0,1.75,1980,1.0,1320,660,1952
2451,440000.0,4.0,2.25,2010,1.0,1220,790,1974
2452,1030000.0,4.0,2.5,2750,2.0,1960,790,1905
2453,775000.0,4.0,2.0,3140,1.0,1940,1200,1939
2454,1335000.0,5.0,2.25,4200,2.5,2910,1290,1906
2455,235000.0,3.0,1.75,1900,1.0,950,950,1980
2456,499950.0,3.0,1.0,1830,1.5,1430,400,1926
2457,622500.0,5.0,2.75,3320,2.0,2190,1130,1975
2458,300000.0,4.0,2.5,2700,1.0,1560,1140,1966
2459,205000.0,3.0,1.0,1290,1.0,1290,0,1976
2460,435000.0,3.0,1.75,1500,1.0,1500,0,1997
2461,697000.0,4.0,2.75,3650,1.5,3650,0,1978
2462,153000.0,3.0,1.0,1270,1.5,1270,0,1944
2463,454000.0,4.0,2.25,2630,2.0,2630,0,1979
2464,345000.0,2.0,1.5,1800,1.0,1240,560,1987
2465,585000.0,3.0,1.0,1870,1.5,1580,290,1927
2466,380000.0,4.0,2.5,2540,2.0,1870,670,2000
2467,250600.0,4.0,2.5,1930,1.0,1120,810,1981
2468,890000.0,4.0,2.25,2770,2.0,2770,0,1974
2469,370000.0,4.0,2.5,2220,2.0,2220,0,2001
2470,369500.0,3.0,1.5,1650,1.0,1100,550,1961
2471,883000.0,4.0,2.5,3670,2.0,3670,0,1999
2472,950000.0,4.0,2.5,3770,2.0,3770,0,1989
2473,615000.0,3.0,1.75,2350,1.0,1800,550,1978
2474,305000.0,3.0,1.5,1210,1.0,610,600,1983
2475,590000.0,4.0,2.5,2010,2.0,2010,0,1989
2476,485000.0,3.0,2.5,1580,2.0,1580,0,1985
2477,215000.0,2.0,1.0,710,1.0,710,0,1943
2478,430000.0,3.0,2.0,1910,1.5,1910,0,1971
2479,324900.0,4.0,2.5,1880,2.0,1880,0,2000
2480,849900.0,2.0,2.0,2280,2.0,2280,0,1990
2481,975000.0,5.0,2.75,3100,1.0,1660,1440,1973
2482,910000.0,5.0,2.5,2350,2.0,2350,0,1993
2483,459950.0,3.0,1.75,1850,1.0,1100,750,1919
2484,325000.0,3.0,2.5,2070,2.0,2070,0,1997
2485,513000.0,4.0,2.75,2020,1.0,1010,1010,1958
2486,475000.0,3.0,2.25,1580,1.0,1200,380,1981
2487,419000.0,4.0,2.5,2690,2.0,2690,0,1993
2488,760000.0,4.0,2.5,2420,1.0,1700,720,1958
2489,1120000.0,5.0,1.5,2540,2.0,2340,200,1954
2490,129000.0,2.0,1.0,1150,1.0,1150,0,1950
2491,725000.0,5.0,2.5,3210,1.0,1830,1380,1968
2492,580000.0,3.0,2.5,2040,2.0,2040,0,1992
2493,385000.0,3.0,2.25,1920,1.0,1060,860,1921
2494,265000.0,4.0,1.75,1900,1.0,1900,0,1958
2496,330000.0,3.0,2.5,1070,2.0,720,350,2005
2497,665000.0,4.0,2.5,2790,2.0,2790,0,1989
2498,799000.0,3.0,2.5,2860,2.0,2860,0,2000
2499,589000.0,3.0,2.0,2250,1.0,1250,1000,1925
2501,538000.0,3.0,1.0,1460,1.0,1260,200,1906
2502,530100.0,3.0,1.0,1540,1.5,1200,340,1926
2503,718500.0,3.0,2.0,2910,2.0,1920,990,1900
2504,299000.0,3.0,1.75,1180,1.0,1180,0,1962
2505,556000.0,3.0,1.75,1640,1.0,1090,550,1948
2506,171000.0,4.0,2.0,1520,1.0,1020,500,1920
2507,540000.0,5.0,3.0,3610,2.0,3610,0,2003
2508,250000.0,3.0,2.25,1400,2.0,1400,0,2012
2509,795000.0,4.0,3.5,3200,2.0,2670,530,2007
2510,575000.0,3.0,3.0,1384,2.0,1144,240,2006
2511,379500.0,3.0,2.25,1410,2.0,1290,120,2005
2512,385000.0,4.0,2.5,2050,2.0,2050,0,2006
2513,415500.0,4.0,2.5,1750,2.0,1750,0,2009
2514,397500.0,3.0,2.0,1510,1.0,1070,440,1972
2515,530000.0,3.0,2.5,1930,2.0,1930,0,2005
2516,883000.0,4.0,2.5,2960,2.0,2960,0,1985
2517,850000.0,5.0,2.75,2920,1.0,1660,1260,1968
2518,496752.0,2.0,1.0,1980,1.0,1090,890,1923
2519,330000.0,3.0,1.75,1430,1.0,1430,0,1950
2520,735000.0,4.0,2.75,2450,2.0,2450,0,2010
2521,525000.0,4.0,2.75,2360,2.0,2360,0,2008
2522,269950.0,3.0,2.5,1890,2.0,1730,160,2002
2523,650000.0,3.0,1.75,2140,1.0,1290,850,1953
2524,520500.0,3.0,2.0,1900,1.0,950,950,1940
2525,652500.0,4.0,2.5,2700,2.0,2700,0,1990
2526,506000.0,5.0,3.0,2430,1.0,1370,1060,1957
2527,416000.0,3.0,1.0,1110,1.0,1110,0,1957
2528,500000.0,4.0,2.75,2280,1.0,2280,0,1960
2529,460000.0,3.0,1.75,1550,1.0,860,690,1949
2530,371025.0,3.0,2.0,1530,1.0,1530,0,1977
2531,576000.0,4.0,2.5,2440,2.0,2440,0,2002
2532,353500.0,4.0,2.25,1760,2.0,1760,0,1987
2534,183000.0,3.0,1.75,1070,1.0,1070,0,1957
2535,763101.0,3.0,1.75,1990,1.0,1100,890,1939
2536,460000.0,2.0,1.5,1090,1.0,970,120,1951
2537,825000.0,4.0,1.5,1890,1.5,1890,0,1919
2538,265000.0,3.0,1.0,1000,1.0,1000,0,1969
2539,295000.0,3.0,1.75,1770,1.0,1030,740,1960
2540,418000.0,4.0,3.0,2360,1.0,1460,900,1960
2541,554000.0,3.0,3.5,3380,2.0,2700,680,1999
2542,534500.0,3.0,2.5,1700,2.0,1700,0,2005
2543,690000.0,2.0,1.75,1600,1.0,850,750,1918
2544,530000.0,4.0,2.5,2050,2.0,2050,0,1988
2545,357186.0,2.0,1.75,1210,2.0,1210,0,2014
2546,300000.0,5.0,3.0,1940,1.0,1200,740,2007
2547,304000.0,4.0,2.0,1810,1.0,1110,700,1967
2548,385000.0,4.0,1.75,1690,1.0,870,820,1984
2549,415000.0,4.0,2.0,1800,1.0,1000,800,1923
2550,963000.0,4.0,3.5,3280,2.0,3280,0,2007
2552,309212.0,3.0,1.75,1150,1.0,1150,0,1979
2553,235000.0,2.0,1.5,880,2.0,880,0,1999
2554,667000.0,3.0,1.5,1720,2.0,1720,0,1907
2555,470000.0,3.0,1.5,1510,1.0,1510,0,1956
2556,375000.0,4.0,2.0,1240,1.0,1040,200,1908
2557,410000.0,4.0,2.0,1580,1.0,1580,0,1953
2558,566000.0,4.0,2.25,2170,2.0,2170,0,1987
2559,680000.0,4.0,2.75,2500,2.0,2500,0,2010
2560,332000.0,1.0,1.0,960,1.0,760,200,1908
2561,902000.0,4.0,2.5,3030,2.0,3030,0,2003
2562,500000.0,3.0,1.75,1540,1.0,770,770,1947
2563,445000.0,3.0,1.75,1890,1.5,1890,0,1976
2564,825000.0,4.0,2.5,2810,1.0,1710,1100,1973
2565,1095000.0,4.0,4.0,3530,2.0,2630,900,1958
2566,277000.0,3.0,1.0,1100,1.0,1100,0,1957
2567,545000.0,3.0,2.5,1940,1.0,1440,500,1975
2568,435000.0,3.0,2.5,2300,2.0,2300,0,2003
2569,638000.0,3.0,2.5,2110,2.0,2110,0,2005
2570,418000.0,4.0,1.5,1220,1.0,1220,0,1965
2571,499000.0,3.0,1.75,1750,1.0,1470,280,1968
2572,150000.0,3.0,1.5,1230,1.0,1230,0,1949
2573,759950.0,3.0,2.5,3100,2.0,3100,0,2002
2574,427000.0,3.0,2.5,1830,1.0,1520,310,1991
2575,632500.0,5.0,2.5,2640,2.0,2640,0,2003
2577,862000.0,4.0,2.5,3190,2.0,3190,0,1990
2578,524000.0,2.0,1.0,1120,1.5,1120,0,1910
2579,470000.0,3.0,1.5,1760,1.0,1160,600,1958
2580,385000.0,3.0,2.0,1590,2.0,1590,0,2000
2581,575000.0,4.0,2.5,2120,2.0,2120,0,1985
2582,220000.0,4.0,2.5,2240,1.0,1370,870,1988
2583,460000.0,2.0,1.0,890,1.0,760,130,1919
2585,175000.0,3.0,1.5,1220,1.0,1220,0,1973
2586,465000.0,3.0,2.25,2670,1.0,1640,1030,1966
2587,552000.0,3.0,1.0,1120,1.0,820,300,1912
2588,565000.0,4.0,2.75,3130,2.0,3130,0,1981
2589,518000.0,4.0,2.5,1740,1.0,1220,520,1976
2590,899950.0,4.0,3.5,3290,2.0,2360,930,2006
2591,373000.0,3.0,1.0,1770,1.5,1140,630,1926
2592,385000.0,4.0,2.5,2960,2.0,2960,0,2006
2593,245000.0,2.0,1.0,1200,1.0,980,220,1943
2594,375000.0,4.0,2.0,2400,2.0,2400,0,1913
2595,699850.0,4.0,3.5,2690,2.0,2690,0,2002
2597,455000.0,2.0,1.5,1310,1.5,1310,0,1970
2598,650000.0,4.0,2.75,2610,3.0,1910,700,1910
2599,378000.0,5.0,2.5,2760,1.0,1600,1160,1960
2600,220000.0,3.0,2.0,1410,1.0,1410,0,1940
2601,285500.0,4.0,1.75,1960,1.0,1960,0,1967
2602,340000.0,3.0,2.5,1212,3.0,1212,0,2004
2603,921000.0,4.0,1.5,2220,1.0,1490,730,1954
2604,375000.0,4.0,2.5,2040,1.5,2040,0,1973
2605,999000.0,4.0,2.75,2800,2.0,2800,0,1992
2606,335000.0,3.0,1.5,2040,1.0,1340,700,1957
2608,385000.0,2.0,1.0,830,1.0,830,0,1928
2609,850000.0,4.0,3.5,4140,2.0,3160,980,2003
2610,429000.0,5.0,2.5,2340,2.0,2340,0,2009
2611,523950.0,3.0,2.25,1420,3.0,1420,0,2006
2612,798800.0,3.0,2.75,2670,1.0,1720,950,2013
2613,284000.0,3.0,2.5,1880,2.0,1880,0,2009
2614,852880.0,4.0,3.25,3450,2.0,3450,0,2014
2615,320000.0,3.0,2.25,1200,3.0,1200,0,2005
2616,749995.0,4.0,3.25,3430,2.0,3430,0,2014
2617,468500.0,3.0,2.5,1350,2.0,1120,230,2007
2618,492500.0,5.0,2.5,2570,2.0,2570,0,2006
2619,685000.0,4.0,3.5,2840,3.0,2840,0,2008
2620,542525.0,4.0,2.5,2650,2.0,2650,0,2014
2621,435000.0,3.0,2.0,1980,3.0,1980,0,2007
2622,242000.0,3.0,1.75,1280,1.5,1280,0,1988
2623,325000.0,4.0,2.5,2610,2.0,2610,0,1987
2624,837700.0,5.0,2.75,3010,2.0,3010,0,1994
2625,210000.0,1.0,1.0,930,1.0,930,0,1948
2626,187500.0,3.0,1.5,1180,1.0,1180,0,1977
2627,560000.0,5.0,1.0,1710,1.5,1320,390,1926
2628,272000.0,3.0,2.0,1380,1.0,1380,0,1989
2629,235000.0,3.0,1.75,1190,1.0,1190,0,1968
2630,259000.0,3.0,2.0,1870,1.0,1270,600,1986
2631,866059.0,5.0,3.5,3130,2.0,2570,560,2014
2632,473000.0,2.0,1.0,900,1.0,900,0,1909
2633,405000.0,3.0,1.5,1880,1.0,1480,400,1968
2634,870000.0,4.0,4.25,3010,2.0,1940,1070,1951
2635,475000.0,3.0,2.25,2280,1.0,1150,1130,1985
2636,499500.0,3.0,2.5,2970,2.0,2970,0,1998
2637,386000.0,2.0,2.5,1620,2.0,1620,0,2008
2638,458000.0,4.0,1.5,1550,1.5,1350,200,1918
2639,550000.0,3.0,1.75,2240,2.0,2240,0,1976
2640,605500.0,3.0,2.5,2830,2.0,2830,0,1989
2641,421000.0,3.0,2.5,2890,2.0,2890,0,2000
2642,536000.0,4.0,2.25,1990,2.0,1990,0,1991
2643,247200.0,3.0,1.75,1370,1.0,1370,0,1982
2644,250000.0,2.0,1.5,1088,2.0,1088,0,1983
2645,204950.0,4.0,1.75,1740,1.0,1180,560,1978
2646,430000.0,3.0,2.0,1730,1.0,1370,360,1978
2647,250000.0,4.0,2.5,1800,2.0,1800,0,1998
2648,260000.0,3.0,1.75,1440,1.0,1090,350,1958
2649,547000.0,4.0,1.0,1720,1.5,1200,520,1926
2650,379900.0,5.0,3.5,2800,2.0,2800,0,1995
2651,738500.0,3.0,2.5,2300,1.0,2300,0,2005
2652,545000.0,4.0,2.25,2030,1.0,1590,440,1967
2653,342000.0,2.0,1.0,740,1.0,740,0,1948
2655,170000.0,4.0,1.0,1920,1.0,1220,700,1966
2656,616000.0,4.0,2.5,2490,2.0,2490,0,1983
2657,640000.0,3.0,2.0,1380,1.0,1380,0,1948
2658,332000.0,3.0,2.5,1530,1.0,1270,260,1993
2659,1010000.0,3.0,3.25,2420,2.0,1840,580,2006
2660,380000.0,4.0,2.5,2150,2.0,2150,0,1991
2661,415000.0,4.0,2.0,1610,1.0,1610,0,1967
2662,1008000.0,4.0,3.5,2650,2.0,2060,590,2001
2663,669000.0,4.0,2.75,2700,2.0,2700,0,1976
2664,260000.0,3.0,1.5,1270,1.0,1150,120,1948
2665,854000.0,4.0,2.75,3150,1.0,2480,670,1986
2666,605000.0,3.0,2.25,2010,2.0,2010,0,1985
2667,320000.0,3.0,1.0,860,1.5,860,0,1927
2668,229950.0,3.0,2.0,1410,1.0,1410,0,1983
2669,255000.0,3.0,1.75,1700,1.0,1700,0,1987
2670,1170000.0,4.0,2.5,2570,2.0,2570,0,2000
2671,479000.0,2.0,2.25,1230,2.0,1020,210,2004
2673,472000.0,3.0,2.5,1180,3.0,1180,0,2010
2674,198000.0,3.0,1.5,1430,1.0,820,610,1980
2675,440000.0,4.0,2.0,1450,1.5,1450,0,1962
2676,506000.0,3.0,1.75,2180,1.0,1480,700,1961
2677,382500.0,4.0,2.5,2210,2.0,2210,0,1993
2678,269500.0,2.0,1.5,1480,1.0,940,540,1978
2679,560000.0,3.0,2.0,2340,1.0,1170,1170,1971
2680,840000.0,4.0,3.5,3860,2.0,3120,740,1996
2681,479500.0,3.0,2.75,2300,2.0,2300,0,2008
2682,402000.0,3.0,1.5,1450,1.0,1010,440,1968
2683,549000.0,2.0,2.5,1380,3.0,1380,0,2006
2684,449950.0,4.0,2.5,2470,2.0,2470,0,1999
2685,493000.0,4.0,1.75,2030,1.5,2030,0,1975
2686,142500.0,4.0,0.75,1440,1.0,1440,0,1948
2687,250000.0,3.0,1.75,1160,1.0,1160,0,1998
2688,729000.0,3.0,1.0,1580,2.0,1580,0,1908
2689,465000.0,2.0,2.75,1430,2.0,995,435,2006
2690,465000.0,2.0,2.0,1494,2.0,1494,0,1943
2691,280000.0,4.0,2.25,1930,1.0,1360,570,1988
2693,667500.0,3.0,2.0,1880,1.0,1030,850,1927
2694,809000.0,3.0,2.5,2590,2.0,2590,0,1988
2695,400000.0,3.0,2.25,2140,2.0,2140,0,1986
2696,310000.0,4.0,2.0,1870,1.5,1870,0,1956
2697,435000.0,2.0,1.0,1230,1.0,1230,0,1928
2698,465950.0,4.0,2.5,2340,2.0,2340,0,2001
2700,253000.0,3.0,1.5,880,1.0,880,0,1945
2701,330000.0,3.0,2.5,3040,2.0,3040,0,2003
2702,554000.0,4.0,1.0,1120,1.5,1120,0,1946
2703,350000.0,3.0,2.0,1380,3.0,1380,0,2013
2704,294999.0,4.0,2.5,1660,2.0,1660,0,1994
2705,1185001.0,3.0,2.75,2500,2.0,2500,0,1905
2706,752000.0,4.0,2.5,2940,2.0,2940,0,1991
2707,451000.0,4.0,2.5,1670,2.0,1670,0,2005
2708,725000.0,4.0,2.75,2630,2.0,2630,0,1994
2709,345000.0,4.0,2.75,2250,1.0,1480,770,1975
2710,206000.0,3.0,1.0,1320,1.0,1320,0,1967
2714,580000.0,5.0,2.0,2700,1.0,1540,1160,1962
2715,430000.0,3.0,1.0,980,1.0,980,0,1950
2716,720000.0,4.0,2.5,2650,2.0,2110,540,1988
2718,936000.0,3.0,1.75,2960,1.0,1480,1480,1952
2719,535000.0,4.0,2.75,3070,2.0,3070,0,2006
2720,286800.0,3.0,2.5,1413,2.0,1413,0,2011
2721,350000.0,2.0,2.5,1260,3.0,1260,0,2005
2722,345000.0,3.0,2.5,1680,2.0,1680,0,2007
2723,435000.0,3.0,2.25,1230,2.0,1080,150,2009
2726,461000.0,3.0,3.25,2770,2.0,1980,790,2006
2727,770000.0,3.0,2.25,2910,2.0,2910,0,1990
2729,330000.0,3.0,2.5,1600,2.0,1600,0,2005
2730,322500.0,4.0,2.5,1820,2.0,1820,0,1994
2732,475000.0,3.0,1.75,1700,1.0,1230,470,1977
2733,250275.0,2.0,1.0,790,1.0,790,0,1942
2734,274500.0,3.0,2.25,1720,1.0,1320,400,1969
2735,284950.0,3.0,1.0,990,1.0,990,0,1960
2736,264950.0,4.0,1.75,1770,1.0,1050,720,1983
2737,242000.0,3.0,2.0,1260,1.0,1260,0,1986
2738,913000.0,4.0,2.5,3640,2.0,3640,0,1999
2739,555000.0,3.0,1.75,2040,1.0,1120,920,1958
2740,711000.0,4.0,1.75,1980,1.0,990,990,1948
2741,403500.0,5.0,2.5,3600,1.0,2410,1190,1968
2743,253779.0,4.0,2.0,2030,1.5,1430,600,1947
2744,384400.0,3.0,3.25,1689,3.0,1689,0,2008
2745,646000.0,5.0,2.75,2870,1.0,1650,1220,1976
2746,415000.0,3.0,1.75,1270,1.0,1270,0,1952
2747,764000.0,4.0,2.5,2790,2.0,2790,0,1997
2748,507000.0,5.0,3.25,3850,2.0,3030,820,2002
2749,545500.0,3.0,2.5,1560,1.5,1360,200,1936
2750,450000.0,3.0,1.75,1180,1.0,760,420,1928
2751,264000.0,4.0,1.75,1820,1.0,1080,740,1980
2752,650000.0,5.0,1.75,1260,1.5,1260,0,1926
2753,365000.0,3.0,2.5,2640,2.0,1680,960,1991
2754,343566.0,2.0,1.0,1100,1.0,1100,0,1954
2755,375000.0,3.0,2.5,1950,2.0,1950,0,1997
2756,295000.0,3.0,2.0,1380,1.0,1380,0,1966
2757,325000.0,3.0,2.75,2200,1.0,1280,920,1977
2758,265000.0,4.0,1.5,2050,1.0,1050,1000,1963
2759,562000.0,5.0,3.0,2795,2.0,2795,0,1996
2760,540000.0,4.0,2.5,2050,2.0,2050,0,1989
2762,279950.0,5.0,1.75,2150,1.0,1460,690,1970
2763,540000.0,3.0,1.75,1970,1.0,1420,550,1963
2764,310000.0,4.0,2.5,2660,1.0,1740,920,1960
2765,190000.0,1.0,1.0,720,1.0,720,0,1914
2766,440000.0,4.0,2.5,2410,2.0,2410,0,2000
2768,230000.0,2.0,1.0,1080,1.0,1080,0,1958
2769,455000.0,3.0,1.75,1180,1.0,1180,0,1981
2770,175000.0,2.0,1.0,660,1.0,660,0,1915
2771,650000.0,3.0,1.75,2920,1.0,1620,1300,1981
2773,192500.0,3.0,1.0,1080,1.5,1080,0,1900
2774,239950.0,3.0,1.75,1670,1.0,1170,500,1978
2776,850000.0,5.0,3.5,3450,1.0,2350,1100,1972
2777,410000.0,4.0,2.0,1970,1.0,1820,150,1961
2778,570000.0,4.0,2.5,2290,2.0,2290,0,1996
2779,469000.0,5.0,2.5,2240,1.0,1140,1100,1966
2780,559000.0,2.0,1.0,1240,1.0,1060,180,1938
2781,739888.0,3.0,2.5,2420,2.0,1690,730,1989
2782,568450.0,5.0,3.5,3260,2.0,3260,0,1969
2783,240000.0,2.0,1.0,670,1.0,670,0,1942
2784,574950.0,5.0,3.25,3160,2.0,3160,0,1980
2785,180000.0,3.0,2.25,1990,2.0,1990,0,1967
2787,300000.0,3.0,2.5,1700,2.0,1700,0,2000
2788,630000.0,4.0,2.5,2807,2.0,2807,0,1996
2789,507000.0,4.0,1.75,1770,1.0,1170,600,1968
2790,287500.0,4.0,2.5,2570,1.0,1590,980,1979
2791,688000.0,3.0,3.0,3450,2.0,3450,0,1983
2792,424000.0,3.0,2.0,1670,1.0,1170,500,1972
2793,400000.0,3.0,1.75,1050,1.5,950,100,1928
2794,620000.0,4.0,2.5,1910,2.0,1910,0,1987
2795,300000.0,3.0,1.0,910,1.0,910,0,1971
2796,615000.0,5.0,2.25,2480,2.0,2480,0,1978
2797,206000.0,2.0,1.5,1820,2.0,1820,0,1921
2798,515500.0,4.0,2.5,2920,2.0,2920,0,2003
2799,554000.0,5.0,2.25,1870,1.0,1170,700,1961
2800,825000.0,4.0,3.5,3810,2.0,3810,0,1938
2801,855000.0,4.0,2.25,2190,2.0,1800,390,1918
2802,315000.0,3.0,2.5,1730,2.0,1730,0,1993
2803,299000.0,5.0,2.5,2220,1.0,1110,1110,1968
2804,650000.0,3.0,1.5,1320,1.0,1320,0,1951
2805,465000.0,3.0,1.75,1510,1.0,860,650,1925
2806,535000.0,3.0,2.0,2120,2.0,2120,0,2003
2807,564000.0,2.0,2.0,1690,1.0,1690,0,2004
2808,515000.0,3.0,3.5,1360,2.0,1040,320,2007
2809,580000.0,4.0,2.5,3250,2.0,3250,0,2008
2810,309000.0,3.0,2.25,1490,2.0,1220,270,2010
2811,536751.0,3.0,1.75,1930,1.0,1930,0,2013
2812,415000.0,4.0,2.5,2020,2.0,2020,0,2010
2813,267000.0,3.0,2.25,1584,2.0,1584,0,2012
2814,820000.0,4.0,2.5,3170,2.0,3170,0,2008
2816,485000.0,2.0,2.5,1430,3.0,1410,20,2008
2817,482000.0,3.0,3.25,1380,3.0,1380,0,2008
2818,535000.0,4.0,2.5,2610,2.0,2610,0,2008
2819,690000.0,3.0,3.25,1540,3.0,1540,0,2013
2820,576000.0,3.0,2.5,1940,1.0,970,970,1948
2821,378750.0,3.0,2.5,2160,1.5,1260,900,1909
2822,269900.0,4.0,1.75,1530,1.5,1530,0,1968
2823,210000.0,3.0,2.0,1440,1.0,1440,0,1983
2824,429900.0,4.0,2.5,2640,2.0,2640,0,1987
2826,360000.0,4.0,2.5,2850,2.0,2850,0,2004
2827,405000.0,2.0,1.0,1260,1.0,1260,0,1947
2828,450000.0,3.0,1.75,1610,1.0,1610,0,1955
2829,703000.0,3.0,2.0,1360,1.5,1360,0,1945
2830,661000.0,4.0,2.5,2496,2.0,2496,0,1998
2831,580000.0,4.0,2.25,2160,1.0,2160,0,1969
2832,464000.0,3.0,1.0,1320,2.0,1320,0,1900
2833,945000.0,2.0,2.5,2540,2.0,2540,0,2004
2834,659500.0,4.0,3.0,2620,1.0,1870,750,1956
2835,200000.0,3.0,1.5,1140,1.0,1140,0,1960
2836,280000.0,3.0,2.0,1790,1.0,1790,0,1990
2837,1325000.0,4.0,2.5,2440,2.5,2440,0,1902
2838,346150.0,3.0,2.0,2140,1.0,1480,660,1966
2839,197500.0,3.0,1.0,1330,2.0,1330,0,1905
2840,799000.0,4.0,2.5,2590,2.0,2590,0,2001
2842,350000.0,2.0,1.0,1620,1.0,850,770,1921
2843,720000.0,4.0,2.5,2440,2.0,2440,0,1987
2844,519000.0,3.0,2.75,2020,1.0,1270,750,1954
2845,590300.0,3.0,1.5,1470,2.0,1470,0,1907
2848,437000.0,2.0,1.75,1440,1.0,1440,0,2005
2849,221000.0,3.0,2.25,1640,1.0,1140,500,1984
2850,380000.0,4.0,2.25,2150,1.0,1090,1060,1963
2851,506000.0,2.0,1.0,1570,1.0,1150,420,1952
2852,395000.0,4.0,1.0,1980,1.0,1430,550,1968
2853,285000.0,3.0,1.0,1210,1.5,1210,0,1901
2854,311000.0,3.0,1.75,1900,1.5,1070,830,1903
2855,520000.0,3.0,1.75,1940,1.0,1940,0,1991
2856,435000.0,3.0,1.75,1310,1.0,1310,0,1948
2857,120000.0,2.0,1.0,990,1.0,990,0,1945
2859,186000.0,3.0,2.0,1340,1.0,920,420,1912
2860,756000.0,4.0,2.25,2160,1.0,1080,1080,1947
2861,248000.0,4.0,2.0,2080,1.0,1040,1040,1950
2862,287000.0,3.0,2.0,1300,1.5,1300,0,1933
2863,510000.0,4.0,2.5,2610,2.0,2610,0,1998
2864,249000.0,3.0,1.0,1050,1.0,1050,0,1959
2865,340000.0,3.0,2.5,2480,2.0,2480,0,2004
2866,399888.0,4.0,2.25,1820,1.5,1320,500,1930
2867,440000.0,3.0,1.75,1170,1.0,1170,0,1968
2868,899000.0,4.0,2.25,2370,1.0,1440,930,1959
2869,540500.0,5.0,3.75,3090,2.0,3090,0,2014
2870,385000.0,3.0,1.75,2310,1.0,1630,680,1978
2871,558000.0,4.0,2.25,2060,1.0,1320,740,1962
2872,600000.0,3.0,2.0,2540,1.0,2540,0,2007
2873,450000.0,4.0,2.5,2400,2.0,2400,0,2003
2874,232500.0,3.0,1.0,1320,1.0,880,440,1961
2875,436000.0,2.0,1.0,790,1.0,790,0,1949
2876,240000.0,4.0,2.0,1790,1.0,1670,120,1960
2877,489950.0,3.0,2.25,1820,2.0,1820,0,1983
2879,1068000.0,5.0,3.5,3990,2.0,3990,0,2001
2880,352450.0,3.0,2.0,1430,1.0,1430,0,1945
2881,335000.0,4.0,2.0,2030,1.0,2030,0,1969
2882,549000.0,4.0,1.75,1290,2.0,1290,0,1906
2883,1240000.0,4.0,3.5,3820,2.0,3280,540,1990
2884,618250.0,4.0,3.25,2520,1.5,1550,970,1931
2886,850000.0,2.0,1.75,1590,1.5,1320,270,1927
2887,930000.0,5.0,2.0,3530,1.5,3530,0,1925
2888,505000.0,3.0,2.5,1610,2.0,1610,0,1996
2889,925000.0,4.0,2.5,3280,2.0,3280,0,1994
2890,275000.0,3.0,1.75,1860,1.0,1860,0,1971
2891,499000.0,3.0,1.75,1840,1.0,920,920,1910
2892,507000.0,3.0,2.5,2120,2.0,2120,0,2003
2893,619850.0,4.0,2.5,2270,1.0,1500,770,1972
2894,500000.0,3.0,2.5,2840,1.0,1870,970,1994
2895,310000.0,4.0,1.5,1220,1.0,1220,0,1980
2896,646000.0,4.0,2.5,2310,2.0,2310,0,2008
2897,265000.0,3.0,1.75,1840,1.0,1840,0,1966
2898,475000.0,3.0,2.5,950,2.0,950,0,2003
2899,600000.0,4.0,2.25,3070,2.0,3070,0,1970
2900,470000.0,3.0,2.0,1730,1.0,1730,0,1997
2901,319950.0,2.0,1.0,920,1.0,920,0,1939
2902,712000.0,3.0,2.75,3200,2.0,3200,0,2004
2903,775000.0,4.0,2.75,3010,2.0,3010,0,1996
2904,390000.0,3.0,2.25,1600,1.0,1090,510,1979
2905,585000.0,4.0,2.5,2840,2.0,2840,0,2001
2906,1027000.0,3.0,2.5,2430,2.0,2430,0,1989
2907,232603.0,3.0,1.75,1750,2.0,1750,0,1976
2908,543000.0,3.0,2.25,1240,3.0,1240,0,2008
2909,607500.0,3.0,3.25,1530,3.0,1530,0,2006
2910,750000.0,3.0,3.5,3390,2.0,3040,350,2012
2911,728050.0,3.0,2.5,2320,1.0,2320,0,2008
2912,734990.0,4.0,2.5,2650,2.0,2650,0,2012
2913,330000.0,3.0,2.5,2238,2.0,2238,0,2011
2914,605000.0,4.0,2.5,2620,2.0,2620,0,1996
2915,441000.0,3.0,2.75,1910,1.0,1160,750,1979
2916,650000.0,4.0,2.5,3040,2.0,3040,0,2003
2918,395000.0,3.0,1.0,1500,1.0,900,600,1925
2919,245000.0,1.0,0.75,380,1.0,380,0,1963
2920,905000.0,4.0,3.5,2970,2.0,2340,630,1997
2921,660000.0,4.0,3.25,3030,2.0,3030,0,1988
2922,378000.0,4.0,2.5,1890,1.0,1230,660,1978
2923,600000.0,2.0,1.0,1040,1.0,1040,0,1919
2924,632500.0,4.0,2.5,2090,2.0,2090,0,1986
2925,210000.0,2.0,2.0,1680,2.0,1680,0,1910
2926,754800.0,2.0,2.5,2770,2.0,2770,0,2006
2927,175000.0,2.0,1.0,1020,1.0,1020,0,1948
2928,455000.0,3.0,2.25,1470,2.0,1470,0,1985
2929,450000.0,3.0,2.0,1430,1.0,980,450,1947
2930,790000.0,4.0,1.75,2050,1.0,1450,600,1974
2931,480000.0,4.0,1.0,2080,1.0,1040,1040,1941
2932,850000.0,3.0,2.25,2870,2.0,2250,620,1995
2933,725000.0,4.0,3.25,3940,2.0,3440,500,2000
2934,380000.0,3.0,1.5,1520,1.0,1020,500,1949
2935,979000.0,3.0,1.5,1700,1.0,1700,0,1954
2936,359950.0,3.0,2.25,1940,1.0,1100,840,1981
2937,665900.0,4.0,2.25,2870,2.0,2220,650,1926
2938,812000.0,3.0,3.25,3240,2.0,3240,0,2001
2939,203000.0,3.0,1.0,1150,1.0,1150,0,1953
2940,456000.0,3.0,1.5,1440,1.0,1440,0,1975
2941,547000.0,5.0,2.5,2200,1.5,1420,780,1916
2942,280000.0,3.0,2.0,1470,1.0,1470,0,1987
2943,640000.0,2.0,1.75,1760,1.0,880,880,1930
2944,477000.0,3.0,1.75,1780,1.0,1210,570,1976
2945,455000.0,4.0,2.25,2450,1.0,1650,800,1954
2946,587206.0,3.0,3.5,1890,2.0,1640,250,1999
2947,425000.0,3.0,2.5,2540,2.0,2540,0,1999
2948,511500.0,4.0,1.0,1360,1.5,1360,0,1917
2949,218000.0,2.0,2.0,1310,2.0,1310,0,2004
2950,332000.0,3.0,2.0,1510,1.0,1510,0,1942
2951,291000.0,3.0,1.5,1860,1.0,1140,720,1967
2952,279000.0,4.0,2.0,2200,1.0,1100,1100,1979
2953,950000.0,4.0,2.5,3360,2.0,3360,0,1988
2954,970500.0,3.0,2.75,2470,2.0,2470,0,1960
2955,412000.0,2.0,1.0,1260,1.0,690,570,1925
2956,400000.0,3.0,1.0,1430,1.5,1430,0,1950
2957,200000.0,3.0,2.25,1230,1.5,1230,0,1913
2958,397000.0,4.0,2.5,2320,2.0,2320,0,1997
2959,715000.0,4.0,2.5,3290,2.0,3290,0,2003
2960,371000.0,4.0,2.5,2550,2.0,2550,0,2005
2961,458000.0,3.0,2.5,1870,2.0,1870,0,2003
2962,436500.0,5.0,3.0,3110,1.0,1790,1320,1977
2963,329950.0,3.0,2.5,1820,2.0,1820,0,1983
2964,950000.0,3.0,3.25,3050,1.0,1650,1400,1962
2965,282000.0,4.0,2.0,1890,2.0,1890,0,1997
2966,250000.0,1.0,1.0,800,1.0,680,120,1931
2968,400000.0,4.0,1.75,2670,2.0,2670,0,1972
2970,200000.0,2.0,1.0,860,1.0,860,0,1949
2971,1300000.0,5.0,4.0,3366,2.5,2966,400,1937
2974,355000.0,4.0,2.5,2040,2.0,2040,0,1996
2975,425000.0,3.0,2.25,1790,1.0,1290,500,1967
2976,869000.0,4.0,3.0,3740,2.0,3060,680,1988
2977,915000.0,3.0,3.25,2660,2.0,2170,490,2003
2979,925000.0,4.0,2.0,3140,1.0,2040,1100,1959
2981,390000.0,3.0,1.0,1160,1.5,1160,0,1910
2982,330000.0,3.0,2.25,1860,2.0,1860,0,1995
2983,482500.0,4.0,3.0,1630,1.0,1110,520,1990
2984,525000.0,3.0,2.25,1750,3.0,1750,0,2001
2985,237000.0,3.0,1.0,1300,1.0,1300,0,1960
2986,205000.0,3.0,1.0,960,1.0,960,0,1960
2987,623000.0,3.0,2.5,1850,2.0,1850,0,1989
2988,565000.0,4.0,2.75,3260,2.0,3260,0,2013
2989,400000.0,4.0,2.25,2420,1.0,1400,1020,1973
2990,405000.0,3.0,1.0,1460,1.5,1460,0,2002
2991,337000.0,4.0,3.0,2240,2.0,2240,0,1992
2992,355000.0,2.0,1.0,1240,1.0,1000,240,1943
2993,885000.0,3.0,2.25,2060,1.0,1610,450,1975
2994,420000.0,5.0,2.75,2280,1.0,1300,980,1959
2995,448000.0,4.0,2.5,2510,2.0,2510,0,2006
2996,800000.0,4.0,2.75,3150,2.0,3150,0,2004
2997,830000.0,5.0,2.25,2780,2.0,2780,0,1978
2999,780000.0,3.0,2.25,2140,2.0,2140,0,1905
3000,325000.0,2.0,1.0,840,1.0,840,0,1948
3001,488800.0,4.0,2.25,2170,1.0,1300,870,1976
3003,489000.0,4.0,2.0,2120,1.0,1060,1060,1940
3005,595000.0,3.0,2.75,3290,2.0,3290,0,1993
3006,359900.0,5.0,2.25,2290,1.0,1290,1000,1973
3008,925000.0,4.0,2.75,3730,2.0,3730,0,2012
3009,625000.0,3.0,2.5,2440,2.0,2440,0,2014
3010,339990.0,3.0,2.5,2570,2.0,2570,0,2014
3011,775950.0,4.0,2.5,2970,2.0,2970,0,2014
3012,420000.0,5.0,3.0,2630,2.0,1670,960,2013
3013,654000.0,3.0,3.25,1530,2.0,1280,250,2005
3014,725000.0,3.0,3.5,3690,2.0,3690,0,2001
3015,375000.0,2.0,1.0,1230,2.0,830,400,1948
3016,1100000.0,3.0,2.5,2200,1.0,1400,800,1952
3017,639500.0,4.0,2.25,2330,2.0,2330,0,1986
3018,849000.0,4.0,2.0,2160,1.5,2160,0,1928
3019,418000.0,4.0,1.5,1550,1.0,1000,550,1956
3020,442900.0,4.0,1.75,1780,1.0,890,890,1943
3021,750000.0,3.0,1.75,2610,1.5,1680,930,1934
3022,930000.0,3.0,2.5,3290,2.0,3290,0,2000
3023,565000.0,2.0,1.75,1330,1.0,960,370,1914
3024,874150.0,4.0,3.5,3530,2.0,2570,960,1987
3025,545000.0,4.0,2.5,2090,2.0,2090,0,1990
3026,500000.0,4.0,2.5,2040,1.0,1420,620,1963
3027,687000.0,4.0,2.5,2370,2.0,2370,0,1966
3028,810000.0,4.0,2.5,2810,2.0,2810,0,1989
3029,439500.0,3.0,2.5,2050,1.0,1570,480,1977
3030,802000.0,3.0,1.75,2870,1.5,1840,1030,1907
3031,732600.0,4.0,2.5,2130,1.0,1230,900,1963
3032,374000.0,4.0,2.5,2580,2.0,2580,0,2004
3033,330000.0,4.0,2.5,2380,2.0,2380,0,1999
3034,365000.0,4.0,2.0,1940,1.0,1940,0,1962
3035,290900.0,2.0,2.0,1610,2.0,1610,0,1930
3036,577000.0,3.0,2.5,2060,1.0,1330,730,1976
3037,280000.0,2.0,1.0,1010,1.0,1010,0,1925
3038,675000.0,4.0,2.5,2810,2.0,2810,0,1982
3039,800000.0,3.0,2.25,2380,1.0,1450,930,1972
3040,299995.0,2.0,1.0,1060,1.0,1060,0,1951
3041,440000.0,3.0,1.75,1560,1.0,1250,310,1983
3042,249500.0,2.0,1.75,1500,1.0,1500,0,1963
3043,690000.0,2.0,1.0,970,1.0,970,0,1907
3044,235000.0,3.0,1.0,1170,1.0,1170,0,1968
3045,320000.0,3.0,2.5,2280,2.0,2280,0,1998
3047,334000.0,4.0,1.5,1150,1.5,1150,0,1970
3049,442000.0,4.0,2.5,2520,2.0,2520,0,1990
3050,264000.0,3.0,1.75,1760,1.0,1760,0,1966
3051,275000.0,2.0,1.0,1180,1.0,1180,0,1949
3052,430000.0,2.0,1.5,950,1.0,950,0,1949
3053,550000.0,3.0,2.5,1900,2.0,1900,0,1988
3054,775000.0,4.0,2.5,2300,2.0,2300,0,1999
3056,230000.0,3.0,1.0,1530,1.5,1530,0,1919
3057,449000.0,4.0,2.5,1850,1.0,1230,620,1930
3059,420000.0,3.0,2.0,1200,1.0,880,320,1937
3060,735000.0,4.0,2.25,2270,1.0,1340,930,1954
3061,200000.0,3.0,1.5,1090,1.0,1090,0,1968
3062,286000.0,3.0,2.75,1100,2.0,780,320,2008
3063,579000.0,3.0,2.5,1640,3.0,1640,0,2009
3064,345100.0,3.0,3.75,1950,1.0,1360,590,1959
3065,350000.0,3.0,1.75,1660,1.5,1660,0,1957
3066,291500.0,3.0,1.0,880,1.5,880,0,1946
3067,649950.0,3.0,2.5,1500,2.0,1200,300,2014
3068,458500.0,3.0,2.0,1890,2.0,1430,460,2012
3069,500000.0,3.0,1.0,1150,2.0,1150,0,1911
3070,362300.0,3.0,2.5,2430,2.0,2430,0,1997
3071,324000.0,4.0,1.75,2110,1.0,1170,940,1975
3072,495000.0,3.0,2.0,2950,2.0,2310,640,1918
3073,233500.0,3.0,2.25,1650,2.0,1650,0,1985
3074,479000.0,3.0,2.25,2110,2.0,2110,0,1978
3075,322200.0,4.0,2.25,2010,2.0,2010,0,1975
3076,835000.0,4.0,2.5,3030,2.0,3030,0,1998
3077,347000.0,3.0,1.0,1270,1.0,1270,0,1955
3078,725000.0,3.0,1.75,1610,1.0,1610,0,1962
3079,345000.0,3.0,1.0,1140,2.0,1140,0,1904
3080,345950.0,3.0,2.5,2110,2.0,2110,0,1989
3081,550000.0,3.0,1.75,1840,1.0,1840,0,1964
3082,399950.0,3.0,1.75,1560,1.0,810,750,1940
3083,269500.0,3.0,1.75,1840,1.0,1240,600,1976
3084,494000.0,4.0,2.5,1830,1.0,1540,290,1973
3085,453000.0,4.0,1.75,2120,1.0,1060,1060,1956
3086,442500.0,3.0,1.75,1600,1.0,1050,550,1977
3087,235000.0,4.0,1.75,1450,1.5,1180,270,1962
3088,389800.0,3.0,1.75,1880,1.0,1880,0,1959
3089,346000.0,3.0,1.75,1270,1.0,880,390,1950
3090,360000.0,4.0,1.5,1720,1.0,1720,0,1953
3091,650000.0,4.0,2.5,2400,2.0,2400,0,1990
3092,290000.0,3.0,1.0,1150,1.0,990,160,1932
3093,234000.0,2.0,1.0,870,1.0,870,0,1940
3094,260000.0,4.0,2.5,2000,2.0,2000,0,1989
3095,349900.0,3.0,2.0,2420,1.0,1210,1210,1949
3096,275000.0,3.0,1.0,1080,1.0,1080,0,1952
3097,725000.0,4.0,2.5,3420,2.0,3420,0,1988
3098,375000.0,4.0,2.5,1870,2.0,1870,0,1990
3099,806000.0,4.0,2.5,2500,1.0,2500,0,1997
3100,470000.0,3.0,2.5,2150,2.0,2150,0,1992
3101,490000.0,3.0,2.25,1470,2.0,1080,390,1984
3102,615000.0,5.0,2.0,2130,1.5,1270,860,1926
3103,249000.0,3.0,1.0,1000,1.0,1000,0,1968
3104,396500.0,3.0,1.75,2390,1.0,1350,1040,1955
3105,405000.0,2.0,1.0,860,1.0,860,0,1901
3106,560000.0,3.0,2.5,1960,2.0,1960,0,1989
3107,459950.0,4.0,2.5,2000,2.0,2000,0,2003
3108,265000.0,3.0,1.0,1620,1.5,1620,0,1928
3110,430000.0,3.0,1.75,1300,1.0,1300,0,1981
3111,525000.0,2.0,1.0,1080,1.0,1080,0,1924
3112,415000.0,4.0,2.5,2170,1.0,1350,820,1955
3113,600000.0,3.0,2.5,2260,2.0,2260,0,1987
3114,225000.0,3.0,1.75,1580,1.0,1580,0,1967
3115,300000.0,4.0,2.5,2620,2.0,2620,0,2008
3116,491234.0,4.0,2.5,1540,2.0,1540,0,2014
3118,905000.0,4.0,3.25,3440,2.0,3440,0,2006
3119,199950.0,5.0,2.5,1740,1.0,1740,0,1959
3120,450000.0,4.0,1.75,2160,1.0,1260,900,1942
3121,899000.0,3.0,1.0,1480,2.0,1480,0,1949
3122,649000.0,2.0,1.75,2260,2.0,1890,370,2005
3123,780000.0,4.0,3.5,3910,2.0,2490,1420,1987
3124,400000.0,4.0,1.75,1700,1.5,1340,360,1965
3126,471001.0,3.0,1.75,1800,1.0,900,900,1905
3127,385000.0,3.0,3.25,1630,3.0,1630,0,2007
3128,326000.0,3.0,1.0,1030,1.0,1030,0,1969
3129,335000.0,1.0,1.0,720,1.0,720,0,1907
3130,320000.0,4.0,1.5,1890,1.0,1890,0,1974
3131,300000.0,4.0,2.5,1840,2.0,1840,0,2004
3132,269950.0,4.0,2.5,2540,2.0,2540,0,1977
3133,1220000.0,4.0,3.75,3520,1.5,2200,1320,1913
3134,590000.0,4.0,2.5,3220,1.5,3220,0,1966
3135,750000.0,3.0,2.0,1820,1.5,1720,100,1941
3136,239950.0,3.0,1.75,1230,1.0,1230,0,1984
3137,215000.0,3.0,2.0,1340,1.0,1340,0,1931
3138,165000.0,3.0,1.0,1200,1.0,1200,0,1943
3139,261350.0,3.0,1.75,1390,1.0,1390,0,1962
3140,569000.0,4.0,2.0,1730,1.0,1060,670,1924
3141,425000.0,3.0,2.25,1580,1.0,1180,400,1992
3142,800000.0,4.0,3.0,3520,1.0,1980,1540,1954
3143,715000.0,4.0,2.5,2650,1.0,1680,970,1960
3144,337000.0,3.0,1.75,1310,1.0,1310,0,1993
3145,560000.0,4.0,2.5,2300,2.0,2300,0,1990
3146,449500.0,3.0,2.25,1780,1.0,1340,440,1972
3147,660000.0,3.0,3.25,1980,3.0,1980,0,1987
3148,685000.0,2.0,1.5,1300,1.0,1300,0,1943
3149,905000.0,5.0,3.5,3500,2.0,2570,930,1996
3150,403500.0,3.0,1.0,1830,1.0,1200,630,1960
3151,405000.0,3.0,2.25,1520,3.0,1520,0,2004
3152,385000.0,4.0,2.75,2700,2.0,2700,0,1984
3154,285000.0,3.0,2.5,1660,2.0,1660,0,2003
3155,249900.0,3.0,2.0,1310,1.0,1310,0,1990
3156,633634.0,4.0,3.5,2960,2.0,2960,0,2014
3157,329900.0,3.0,2.5,2242,2.0,2242,0,2011
3158,310000.0,3.0,2.5,2540,2.0,2540,0,2006
3159,345000.0,3.0,1.5,1420,2.0,1140,280,2008
3160,160797.0,3.0,1.5,1270,2.0,1270,0,2012
3161,562500.0,3.0,2.25,1300,2.0,1000,300,2006
3162,664950.0,5.0,3.0,3190,1.0,1890,1300,2013
3163,515000.0,5.0,3.25,2910,2.0,2040,870,2013
3164,497000.0,3.0,2.25,1630,2.0,1630,0,2005
3165,312891.0,5.0,3.0,2300,2.0,2300,0,2013
3166,670000.0,3.0,2.5,3310,2.0,2440,870,2008
3167,362500.0,2.0,1.5,940,2.0,940,0,2009
3168,402101.0,2.0,0.75,1020,2.0,1020,0,2009
3169,438000.0,3.0,1.75,1520,1.0,790,730,1948
3170,687500.0,4.0,1.75,2330,1.5,1510,820,1929
3171,160000.0,3.0,1.5,1010,1.0,1010,0,1962
3172,415000.0,3.0,1.75,1070,1.0,1070,0,1977
3173,405000.0,3.0,2.5,3170,2.0,2360,810,1995
3174,880000.0,4.0,2.5,3030,3.0,3030,0,2005
3175,585000.0,3.0,2.5,2270,2.0,2270,0,1998
3176,640000.0,4.0,2.5,2341,2.0,2341,0,1997
3177,819000.0,3.0,3.5,2130,2.0,1530,600,1908
3178,520000.0,3.0,1.75,2300,1.0,2300,0,1984
3179,367500.0,3.0,1.0,1660,1.0,1160,500,1978
3180,762500.0,4.0,2.75,2610,1.0,1760,850,1978
3181,300000.0,3.0,1.0,2150,1.0,2150,0,1954
3182,625000.0,3.0,2.5,2410,1.0,1820,590,1976
3183,530000.0,2.0,1.5,1580,1.0,1280,300,1941
3184,379000.0,3.0,2.5,1740,2.0,1740,0,1992
3185,615000.0,2.0,1.0,1270,1.0,1090,180,1949
3186,660000.0,2.0,2.25,2550,2.0,1860,690,1902
3187,380000.0,3.0,2.25,1860,2.0,1860,0,1963
3188,314900.0,4.0,1.75,2700,1.0,1380,1320,1958
3189,324950.0,3.0,1.5,1460,1.0,1460,0,1955
3190,225000.0,3.0,1.75,1330,1.0,1330,0,1968
3191,535000.0,3.0,2.5,2070,2.0,2070,0,1999
3192,348500.0,3.0,1.5,1360,1.0,1360,0,1966
3193,725000.0,4.0,2.5,2650,2.0,2650,0,1986
3194,925000.0,4.0,3.0,3580,1.5,3580,0,1985
3195,549000.0,2.0,1.0,2034,1.0,1159,875,1947
3196,400000.0,3.0,2.0,1230,1.0,990,240,1984
3197,620000.0,4.0,2.5,2450,2.0,2450,0,1994
3199,1215000.0,4.0,3.75,3820,1.0,3820,0,1994
3200,1157400.0,3.0,2.5,2740,2.0,2740,0,1913
3201,349950.0,4.0,2.5,2090,2.0,2090,0,1989
3203,339000.0,4.0,2.0,2470,1.5,1970,500,1948
3204,615000.0,3.0,1.75,1720,1.0,960,760,1924
3205,751000.0,4.0,3.25,3090,2.0,2370,720,2004
3206,941000.0,4.0,1.75,2320,1.5,1820,500,1926
3207,600000.0,4.0,1.75,1740,1.0,1740,0,1968
3208,455000.0,4.0,2.5,2950,2.0,2950,0,2005
3210,485000.0,3.0,2.5,1500,1.0,900,600,1920
3211,358000.0,3.0,1.5,1810,1.0,1810,0,1969
3212,339000.0,3.0,1.0,1100,1.0,720,380,1942
3213,258000.0,3.0,1.0,1490,1.0,1120,370,1969
3214,455000.0,2.0,1.5,1200,2.0,1000,200,2013
3215,437000.0,4.0,2.5,1890,1.0,1290,600,1980
3216,689000.0,3.0,1.75,2200,1.0,1500,700,1978
3217,319000.0,4.0,2.5,2510,1.0,1610,900,1978
3218,510000.0,3.0,2.25,1420,3.0,1420,0,2006
3219,440000.0,3.0,1.75,2000,1.0,1480,520,1957
3220,1010000.0,2.0,2.0,1460,1.0,1460,0,1900
3221,875000.0,4.0,2.5,3220,2.0,3220,0,1996
3222,304000.0,4.0,2.0,1310,1.0,1310,0,1953
3223,139000.0,2.0,1.0,690,1.0,690,0,1942
3224,464500.0,3.0,1.75,1150,1.0,1150,0,1959
3225,336500.0,3.0,1.0,1480,1.0,970,510,1963
3226,230000.0,4.0,1.75,1850,1.0,1270,580,1944
3227,425000.0,3.0,2.5,1930,2.0,1930,0,1990
3228,300000.0,2.0,1.0,750,1.0,750,0,1941
3229,457500.0,3.0,2.25,1430,2.0,980,450,1996
3230,366000.0,3.0,1.75,1840,1.0,1340,500,1977
3231,502000.0,3.0,2.0,1300,1.0,1300,0,1955
3232,194000.0,3.0,1.0,1050,1.0,1050,0,1983
3233,305000.0,4.0,2.25,2210,2.0,2210,0,1968
3234,1250000.0,4.0,2.5,3220,1.0,1680,1540,1973
3236,343500.0,4.0,1.75,1760,1.0,1180,580,1950
3237,325000.0,3.0,1.0,850,1.0,850,0,1948
3239,850000.0,4.0,3.5,3920,2.0,3920,0,1996
3240,420000.0,3.0,2.5,2140,2.0,2140,0,2005
3241,257500.0,2.0,2.0,1180,1.0,1180,0,1940
3242,317000.0,5.0,2.5,2360,1.0,1180,1180,1962
3243,970000.0,3.0,2.25,3060,1.5,1810,1250,1930
3244,252000.0,3.0,2.25,1670,1.0,1190,480,1977
3245,683500.0,3.0,1.5,1820,1.5,1640,180,1946
3246,289000.0,3.0,2.5,1970,2.0,1090,880,1988
3247,355000.0,2.0,2.25,930,2.0,630,300,2007
3248,675000.0,3.0,3.5,2300,1.0,2300,0,2004
3249,396500.0,3.0,2.5,2590,1.0,2590,0,1976
3250,362500.0,4.0,1.75,1450,1.0,1450,0,1960
3251,395000.0,4.0,1.75,1540,1.0,770,770,1943
3252,599000.0,5.0,2.75,2730,1.0,2080,650,1968
3253,218000.0,3.0,1.0,880,1.0,880,0,1945
3254,589950.0,4.0,2.5,3190,2.0,3190,0,2006
3255,218000.0,3.0,1.5,1330,1.0,1330,0,1968
3256,360000.0,3.0,1.75,1500,1.0,1500,0,1957
3257,350000.0,2.0,1.0,740,1.0,740,0,1922
3258,350000.0,4.0,3.0,2560,2.0,2560,0,2004
3259,845000.0,3.0,2.0,2540,1.5,1840,700,1930
3260,839000.0,3.0,2.5,3200,1.0,3200,0,2000
3261,850000.0,4.0,3.0,3330,1.0,1790,1540,1958
3262,329950.0,2.0,1.0,900,1.0,900,0,1956
3263,425000.0,4.0,1.5,1600,1.5,1600,0,1946
3264,210000.0,2.0,1.0,970,1.0,970,0,1956
3265,631500.0,2.0,1.0,1130,1.0,1130,0,1927
3266,295000.0,2.0,1.0,650,1.0,650,0,1950
3267,575000.0,3.0,2.25,2400,1.5,1440,960,1926
3268,415000.0,3.0,2.5,2280,2.0,2280,0,2011
3270,639888.0,4.0,2.5,2050,2.0,2050,0,2012
3271,329445.0,2.0,1.5,830,2.0,830,0,2005
3272,745641.0,4.0,2.5,2440,2.0,2440,0,2013
3273,395000.0,3.0,2.5,1600,2.0,1600,0,2007
3274,790000.0,4.0,3.5,3190,2.0,3190,0,2010
3275,890000.0,4.0,1.0,2550,2.0,2370,180,1905
3276,400000.0,3.0,2.5,2180,1.0,1420,760,1962
3277,365500.0,3.0,2.0,1410,1.0,1410,0,1983
3278,245000.0,3.0,2.0,1410,1.0,1410,0,1985
3279,390000.0,4.0,2.5,2340,2.0,2340,0,1993
3280,196500.0,3.0,1.0,1320,1.0,1320,0,1966
3281,1200000.0,4.0,1.75,3990,2.0,3990,0,2006
3282,276900.0,3.0,1.0,1270,1.0,1270,0,1958
3285,505000.0,3.0,2.5,1860,2.0,1860,0,1987
3286,1229000.0,4.0,3.5,3770,2.0,2830,940,1989
3287,352000.0,4.0,1.0,1530,1.0,980,550,1925
3288,597326.0,4.0,4.0,3570,2.0,2860,710,2013
3289,800000.0,2.0,1.0,1740,1.0,1740,0,1955
3290,270000.0,3.0,2.5,1670,1.0,1300,370,1990
3291,235000.0,4.0,2.0,1570,2.0,1570,0,1984
3292,409900.0,2.0,2.5,1590,2.0,1590,0,1997
3293,739900.0,5.0,2.5,2980,2.0,2980,0,2006
3294,608000.0,4.0,2.5,2690,2.0,2690,0,2001
3295,381500.0,2.0,1.0,900,1.0,900,0,1924
3296,562100.0,2.0,0.75,1440,1.0,1200,240,1914
3297,740000.0,4.0,2.5,3000,2.0,3000,0,1995
3298,308000.0,3.0,1.0,1640,1.5,1640,0,1942
3299,905000.0,5.0,3.5,3100,1.0,1660,1440,1970
3300,762000.0,4.0,3.5,4000,2.0,4000,0,2007
3301,356000.0,4.0,2.0,2020,1.5,2020,0,1949
3302,750000.0,3.0,1.5,1840,1.5,1340,500,1915
3303,418800.0,4.0,2.25,2100,1.0,1290,810,1973
3304,276000.0,4.0,2.25,2460,1.0,2460,0,1959
3305,725000.0,3.0,2.5,2610,2.0,2610,0,1996
3306,285000.0,3.0,2.0,1460,1.0,1460,0,1995
3307,205000.0,3.0,1.0,1050,1.0,1050,0,1958
3308,583000.0,3.0,2.5,1790,2.0,1790,0,1989
3309,657000.0,4.0,2.5,2180,1.5,1420,760,1926
3310,386000.0,4.0,2.25,2050,2.0,1770,280,1965
3311,589950.0,5.0,3.0,2790,1.0,1500,1290,1973
3312,575000.0,3.0,2.25,1700,1.5,1100,600,1924
3313,574000.0,3.0,2.5,2380,2.0,2380,0,2002
3314,690500.0,5.0,2.0,2000,1.5,1280,720,1908
3315,565000.0,2.0,1.75,1670,1.0,1670,0,2005
3316,500000.0,3.0,1.5,1190,1.0,970,220,1940
3318,286000.0,2.0,1.0,780,1.0,780,0,1930
3319,450000.0,3.0,1.5,2330,1.0,1330,1000,1954
3320,870000.0,4.0,2.75,2840,1.5,1960,880,1912
3321,725000.0,4.0,2.5,2490,2.0,2490,0,2000
3322,275000.0,2.0,1.0,770,1.0,770,0,1927
3323,645000.0,3.0,2.75,1850,1.0,1850,0,1953
3324,152000.0,3.0,1.0,1090,1.0,1090,0,1969
3325,315000.0,4.0,2.0,1780,1.5,930,850,1918
3326,190000.0,1.0,0.75,930,1.0,930,0,1941
3327,700000.0,4.0,2.5,2770,2.0,2770,0,2004
3328,233000.0,3.0,1.0,1250,1.5,1250,0,1955
3329,249000.0,4.0,2.25,1830,2.0,1830,0,1990
3330,310000.0,2.0,1.0,870,1.0,870,0,1950
3331,265950.0,3.0,1.5,1150,1.0,1150,0,1951
3333,200000.0,3.0,1.0,1150,1.5,1150,0,1938
3334,402000.0,4.0,2.25,2000,2.0,1650,350,1926
3336,505000.0,3.0,1.75,1640,1.0,1640,0,1975
3337,1355000.0,3.0,1.5,2680,2.0,1880,800,1913
3338,482000.0,3.0,2.5,2420,2.0,2420,0,1998
3339,299950.0,3.0,1.75,1790,1.0,1790,0,1978
3340,770000.0,4.0,2.5,3920,2.0,3920,0,1997
3341,245700.0,3.0,2.25,1640,1.0,1180,460,1968
3342,283000.0,3.0,1.0,890,1.0,890,0,1954
3343,650000.0,4.0,2.75,1910,1.0,1420,490,1940
3344,530000.0,5.0,2.25,2140,1.0,1070,1070,1962
3345,440000.0,3.0,1.75,2030,1.0,2030,0,1953
3347,599990.0,3.0,2.25,2680,1.0,1570,1110,1978
3348,544000.0,4.0,2.5,2030,2.0,2030,0,1994
3350,270000.0,2.0,1.0,2060,1.0,1260,800,1962
3351,435000.0,2.0,1.0,1060,1.5,1060,0,1943
3352,349000.0,3.0,1.0,1010,1.0,1010,0,1947
3353,1140000.0,4.0,2.25,3310,2.0,3310,0,1924
3354,320000.0,4.0,2.5,2000,2.0,2000,0,1997
3355,804100.0,4.0,2.5,3070,2.0,3070,0,2005
3356,594000.0,3.0,2.25,1270,2.0,1060,210,2014
3357,531500.0,4.0,2.75,3110,1.0,3110,0,1958
3358,1150000.0,3.0,2.0,2110,2.0,2110,0,1979
3359,374500.0,3.0,2.25,1400,2.0,1400,0,1984
3360,450000.0,4.0,2.75,2310,1.0,1330,980,1952
3361,744500.0,5.0,2.5,2700,1.0,1750,950,1967
3362,913888.0,5.0,2.25,2370,2.0,2370,0,1981
3363,760000.0,4.0,2.5,2760,2.0,2230,530,1942
3364,346500.0,2.0,1.75,1610,1.0,1010,600,1941
3365,280000.0,3.0,1.75,1230,1.0,1230,0,1966
3366,557500.0,3.0,1.75,1900,1.0,1900,0,1959
3367,260000.0,3.0,1.5,1580,1.0,1140,440,1954
3368,1330000.0,3.0,1.5,1940,1.5,1940,0,1900
3369,640000.0,3.0,1.75,1620,1.0,1040,580,1947
3371,205000.0,3.0,1.0,1230,1.0,1230,0,1965
3372,957000.0,5.0,3.25,3160,2.0,2180,980,2005
3373,625000.0,5.0,2.5,2700,1.0,1950,750,1955
3374,680000.0,4.0,1.5,1880,1.0,1440,440,1954
3375,150000.0,2.0,1.0,890,1.0,890,0,1942
3376,255950.0,3.0,2.5,1720,2.0,1720,0,1992
3377,246500.0,3.0,2.5,1620,2.0,1620,0,1989
3378,450000.0,2.0,1.0,1380,1.0,880,500,1931
3379,595888.0,3.0,1.75,1870,1.0,1870,0,1958
3380,454000.0,3.0,1.0,1970,1.0,1970,0,1970
3381,299900.0,3.0,1.0,1110,1.0,1110,0,1979
3382,200000.0,3.0,2.0,1190,1.0,1190,0,1995
3383,346500.0,3.0,1.0,1150,1.0,1150,0,1932
3384,585000.0,4.0,2.75,2890,1.0,1560,1330,1973
3385,383000.0,3.0,1.75,1500,1.0,1500,0,1977
3386,519000.0,4.0,2.5,1950,1.5,1250,700,1910
3387,410000.0,3.0,1.5,1250,1.0,1250,0,1968
3388,578000.0,4.0,2.5,2070,2.0,2070,0,1996
3390,395000.0,2.0,2.25,1350,2.0,1050,300,2007
3391,364000.0,3.0,2.5,1800,2.0,1800,0,2011
3392,240000.0,3.0,2.25,1481,2.0,1481,0,2012
3393,328423.0,3.0,2.5,1730,2.0,1730,0,2014
3394,594000.0,4.0,2.75,2720,2.0,2720,0,2005
3395,425000.0,3.0,2.5,2320,3.0,2320,0,2009
3396,309620.0,3.0,2.5,1860,2.0,1860,0,2012
3397,260000.0,5.0,2.5,2025,2.0,2025,0,2007
3399,975000.0,5.0,3.0,2620,2.0,2620,0,2009
3400,937000.0,3.0,1.75,2450,2.0,1750,700,1915
3401,518500.0,3.0,3.5,1590,3.0,1590,0,2010
3402,563500.0,4.0,1.75,2085,1.0,1610,475,1964
3403,1050000.0,4.0,3.5,3450,2.0,3450,0,2007
3404,350000.0,3.0,2.25,1780,2.0,1780,0,1987
3405,826000.0,4.0,2.5,3060,2.0,3060,0,2006
3406,225000.0,3.0,2.0,1700,1.0,970,730,1945
3407,235867.0,4.0,2.0,1330,1.0,1330,0,1942
3408,399000.0,4.0,3.0,3060,2.0,3060,0,2001
3409,177500.0,3.0,1.5,1220,1.0,1220,0,1968
3410,224000.0,4.0,1.5,1600,1.0,1600,0,1959
3411,302000.0,4.0,1.75,1530,1.5,1530,0,1968
3412,760000.0,3.0,2.5,1980,1.0,1980,0,1959
3413,460000.0,3.0,2.5,1730,1.0,1210,520,1969
3414,415000.0,3.0,1.0,1170,1.0,1170,0,1957
3415,669000.0,2.0,1.75,1950,1.0,1160,790,1952
3416,254600.0,3.0,2.0,1470,1.0,1470,0,1968
3417,357250.0,3.0,1.5,1400,1.0,1400,0,1952
3418,910000.0,4.0,3.5,4040,2.0,4040,0,1987
3420,670000.0,3.0,1.5,1490,1.5,1490,0,1906
3421,440000.0,4.0,1.5,1770,2.0,1770,0,1947
3422,1025000.0,4.0,3.5,3320,1.0,2040,1280,1977
3423,320000.0,2.0,1.0,950,1.0,950,0,1948
3424,310000.0,4.0,2.5,2430,2.0,2430,0,2002
3425,772650.0,4.0,2.5,2660,1.0,2660,0,1955
3426,669950.0,4.0,2.5,2670,2.0,2670,0,1996
3427,690000.0,5.0,3.5,2720,2.0,1860,860,1993
3429,663000.0,3.0,2.5,2480,1.5,2480,0,1974
3430,300000.0,3.0,2.25,1780,1.0,1780,0,1967
3431,225500.0,2.0,1.75,1590,1.0,1590,0,1972
3432,320000.0,3.0,2.0,1550,1.5,1550,0,1999
3433,775000.0,3.0,2.75,2850,1.0,1920,930,1976
3434,805000.0,3.0,2.75,2600,1.5,1600,1000,1929
3435,252750.0,4.0,1.0,1230,1.5,1230,0,1944
3436,254000.0,5.0,2.0,2080,1.0,1740,340,1959
3438,435000.0,4.0,2.75,2110,1.0,1510,600,1962
3439,460000.0,4.0,2.5,2550,1.0,1300,1250,1961
3440,268000.0,3.0,2.5,1650,2.0,1650,0,1991
3441,446000.0,2.0,1.5,1370,2.0,1080,290,2008
3442,285000.0,2.0,1.0,1010,1.0,1010,0,1975
3443,530000.0,3.0,2.0,2330,2.5,2330,0,1987
3444,402000.0,2.0,1.0,620,1.0,620,0,1911
3445,358000.0,3.0,1.5,2450,1.0,2450,0,1967
3446,354950.0,4.0,2.75,2530,1.0,1280,1250,1977
3447,405000.0,4.0,2.5,2220,2.0,2220,0,2001
3448,568000.0,4.0,1.75,2110,1.0,2110,0,1979
3449,575000.0,5.0,3.0,3690,1.0,2690,1000,1960
3450,315000.0,4.0,2.5,1940,1.0,1140,800,1977
3451,280927.0,4.0,2.25,2070,2.0,2070,0,1977
3452,440000.0,4.0,2.5,2160,1.0,1390,770,1976
3453,270000.0,4.0,2.25,2600,1.0,1600,1000,1965
3454,755000.0,4.0,2.75,2880,1.5,2100,780,1912
3455,289659.0,4.0,2.25,2260,2.0,2260,0,1984
3456,555000.0,5.0,3.0,3640,2.0,3640,0,2004
3457,450000.0,3.0,1.5,1530,1.0,1530,0,1952
3458,1145000.0,3.0,2.5,2490,2.0,1670,820,1918
3459,495000.0,3.0,1.75,1440,1.0,1440,0,1983
3460,1250000.0,3.0,3.0,3760,2.5,3060,700,1910
3461,580000.0,4.0,1.75,1720,1.0,1420,300,1975
3462,560000.0,4.0,2.5,2480,1.0,1510,970,1959
3463,1080000.0,4.0,3.5,3990,2.0,3990,0,2008
3464,450000.0,2.0,1.75,840,1.0,700,140,1912
3465,815000.0,3.0,2.0,2270,1.0,2270,0,1968
3466,354000.0,4.0,2.5,2580,2.0,2580,0,2005
3467,279900.0,3.0,1.75,1580,1.0,1580,0,1988
3468,339000.0,2.0,1.0,950,1.0,950,0,1941
3469,1340000.0,4.0,3.5,3190,2.0,2160,1030,2003
3470,710000.0,3.0,3.25,3740,2.5,3100,640,1990
3471,815000.0,4.0,2.75,2620,1.0,1310,1310,1949
3472,800000.0,3.0,1.75,2080,1.0,2080,0,1958
3473,638000.0,3.0,2.0,1660,1.0,970,690,1922
3474,475580.0,3.0,1.75,1520,1.0,1520,0,1983
3475,243800.0,3.0,1.0,1140,1.0,1140,0,1981
3476,600000.0,3.0,2.5,3240,2.0,2910,330,2004
3477,620000.0,3.0,2.0,2460,1.0,2460,0,1988
3478,750000.0,4.0,2.75,1750,1.5,1750,0,1903
3479,626000.0,3.0,1.75,2430,2.0,1760,670,1945
3480,230000.0,3.0,1.0,1060,1.0,1060,0,1956
3481,537000.0,3.0,3.0,2410,2.0,2410,0,1942
3482,210000.0,2.0,1.0,720,1.0,720,0,1943
3483,200500.0,3.0,1.75,1260,1.0,1260,0,1963
3484,253500.0,3.0,1.0,1640,1.0,1090,550,1954
3485,150000.0,3.0,1.0,1310,1.0,960,350,1962
3486,440000.0,3.0,1.5,2120,1.0,1220,900,1949
3487,667000.0,3.0,1.75,3320,1.5,2260,1060,1933
3488,660000.0,3.0,1.0,1210,1.0,1210,0,1955
3489,695000.0,3.0,2.75,2590,2.0,2590,0,1993
3490,440000.0,4.0,2.5,2250,2.0,2250,0,1989
3492,219500.0,3.0,1.0,1090,1.5,1090,0,1912
3493,220000.0,3.0,1.5,1660,2.0,1660,0,1981
3494,270000.0,2.0,1.0,1780,1.0,1780,0,1954
3495,900000.0,4.0,3.5,3370,2.0,2470,900,2008
3497,800000.0,4.0,2.5,2990,2.0,2990,0,1990
3498,365000.0,5.0,2.0,2280,1.5,2280,0,1924
3500,451000.0,5.0,2.75,2830,1.5,2830,0,1967
3501,202000.0,2.0,1.0,920,1.0,920,0,1950
3503,471000.0,2.0,1.75,1240,1.0,1240,0,1924
3504,827000.0,4.0,2.5,3230,1.0,1870,1360,1977
3505,235000.0,5.0,2.5,2500,1.0,1300,1200,1979
3506,216500.0,2.0,1.75,1390,1.0,1390,0,1980
3507,359000.0,5.0,1.75,1940,1.5,1940,0,1953
3508,252500.0,3.0,2.0,1900,1.0,1900,0,1991
3509,370000.0,3.0,1.5,2380,1.0,1850,530,1961
3510,663000.0,3.0,2.0,1480,1.0,860,620,1928
3511,971971.0,4.0,3.75,3460,2.0,3460,0,2013
3512,420000.0,3.0,1.75,1444,1.5,1444,0,2008
3513,330675.0,4.0,3.0,1930,1.0,1200,730,2006
3514,240000.0,4.0,1.0,1200,1.5,1200,0,1933
3515,334888.0,3.0,2.5,1769,2.0,1769,0,2012
3516,414000.0,3.0,2.5,2490,2.5,2490,0,2012
3517,782900.0,4.0,3.25,3060,2.0,2300,760,2014
3518,525000.0,4.0,2.75,3030,2.0,3030,0,2011
3519,429900.0,3.0,2.5,2370,2.0,2370,0,2009
3520,390000.0,3.0,3.25,1370,2.0,1100,270,2006
3521,224000.0,3.0,1.75,1500,1.0,1500,0,2014
3522,257500.0,3.0,2.25,1715,2.0,1715,0,1995
3523,665000.0,2.0,1.0,1110,1.0,1110,0,1925
3524,327000.0,5.0,2.75,2400,2.0,2400,0,1998
3525,425000.0,3.0,1.0,1520,1.5,1520,0,1988
3526,687500.0,4.0,2.75,3190,2.0,3190,0,1994
3527,672500.0,3.0,2.25,2400,1.5,1250,1150,1939
3528,140000.0,3.0,1.0,1060,1.0,1060,0,1959
3529,215500.0,2.0,1.75,1220,1.0,1220,0,1972
3530,464900.0,4.0,2.25,2020,1.0,1380,640,1979
3531,417000.0,4.0,2.25,2300,1.0,1380,920,1959
3532,453000.0,4.0,2.75,2300,1.0,1550,750,1979
3533,700000.0,3.0,2.5,1660,2.0,1400,260,2002
3535,259500.0,3.0,1.75,1650,1.0,1650,0,1957
3536,460000.0,4.0,2.5,2110,1.0,1290,820,1985
3537,561500.0,3.0,1.75,1960,1.0,980,980,1939
3538,641000.0,4.0,2.5,2770,2.0,2770,0,1997
3539,330000.0,4.0,1.75,2440,1.0,1610,830,1978
3540,447000.0,2.0,1.0,1320,1.0,1320,0,1953
3541,320000.0,4.0,2.5,2570,2.0,2570,0,2005
3542,212700.0,2.0,1.0,940,1.0,940,0,1926
3543,260000.0,2.0,1.0,700,1.0,700,0,1922
3544,410000.0,3.0,2.0,1400,2.0,1400,0,1981
3545,355000.0,4.0,2.5,1890,2.0,1890,0,1996
3546,275500.0,2.0,1.0,720,1.0,720,0,1951
3547,415000.0,3.0,1.75,2410,1.0,1860,550,1967
3548,279000.0,3.0,2.5,1630,1.0,1320,310,1985
3549,350000.0,5.0,1.75,2330,1.0,1180,1150,1968
3550,355000.0,2.0,2.25,1330,2.0,1330,0,1985
3551,750000.0,4.0,2.25,3190,2.0,2300,890,1984
3552,235000.0,3.0,1.75,1400,1.0,1400,0,1998
3553,209950.0,3.0,1.0,970,1.0,970,0,1967
3554,230000.0,3.0,1.75,1010,1.0,1010,0,1969
3555,725000.0,3.0,2.5,3580,1.5,3580,0,1990
3556,430000.0,2.0,1.0,1050,1.0,850,200,1927
3557,661500.0,5.0,2.5,2500,1.0,1490,1010,1977
3558,738000.0,3.0,3.0,2630,2.0,2630,0,2006
3560,221000.0,3.0,1.0,910,1.0,910,0,1966
3561,665000.0,3.0,2.5,2610,2.0,2610,0,1988
3562,255000.0,3.0,2.5,1720,2.0,1720,0,1998
3563,1195000.0,5.0,2.75,3650,2.0,2750,900,1969
3564,355000.0,3.0,1.75,2040,1.0,2040,0,1980
3565,755000.0,5.0,2.5,3260,1.5,2310,950,1950
3566,300000.0,3.0,1.5,1590,1.0,1590,0,1956
3567,500000.0,4.0,1.0,1440,1.5,1440,0,1906
3568,191000.0,2.0,1.0,900,1.0,900,0,1905
3570,415000.0,3.0,2.5,1060,2.0,1060,0,2000
3571,394000.0,4.0,2.5,3000,2.0,3000,0,2002
3572,490000.0,3.0,2.5,2230,2.0,2230,0,2000
3573,523460.0,5.0,1.75,1890,1.5,1090,800,1906
3575,342000.0,3.0,1.75,1780,1.0,1280,500,1981
3576,560000.0,4.0,2.5,2710,2.0,2710,0,2003
3577,1050000.0,4.0,4.25,4390,2.0,3320,1070,2003
3578,710000.0,2.0,1.5,1640,1.5,1540,100,1916
3579,1020000.0,3.0,2.25,1670,1.5,1670,0,1903
3580,399950.0,3.0,2.5,2570,2.0,2570,0,1989
3581,480000.0,2.0,1.0,1500,1.0,1500,0,1902
3582,410000.0,3.0,1.0,2710,2.0,2710,0,1950
3583,530000.0,4.0,1.75,2860,1.0,1710,1150,1978
3584,528000.0,2.0,0.75,840,1.0,840,0,1937
3585,469900.0,4.0,2.5,2990,2.0,2990,0,1991
3586,397000.0,5.0,1.0,1170,1.0,800,370,1944
3587,718500.0,3.0,1.5,1200,1.0,1030,170,1952
3588,195000.0,2.0,1.0,1020,1.0,1020,0,1940
3589,285000.0,2.0,1.0,910,1.0,910,0,1948
3590,295000.0,1.0,1.0,700,1.0,700,0,1907
3591,602000.0,4.0,1.75,2420,1.0,1880,540,1981
3592,235000.0,3.0,1.75,1950,1.0,1950,0,1960
3593,465000.0,4.0,2.5,3060,2.0,3060,0,2012
3594,234000.0,4.0,1.0,1390,1.0,1390,0,1955
3595,504200.0,2.0,1.5,1200,3.0,1200,0,2008
3596,710000.0,3.0,2.5,2440,2.0,2440,0,2003
3597,589500.0,3.0,3.25,2310,2.0,1730,580,2005
3598,415000.0,3.0,2.75,2600,1.5,2600,0,2009
3599,735000.0,3.0,2.25,1490,2.0,1040,450,2011
3600,427000.0,3.0,2.5,2432,2.0,2432,0,2005
3601,982000.0,4.0,2.75,3610,2.0,3610,0,2014
3602,459000.0,4.0,3.0,2530,2.0,2530,0,2013
3603,483453.0,4.0,2.75,2790,2.0,2790,0,2014
3604,246950.0,3.0,3.0,1670,1.0,1670,0,2014
3605,235000.0,1.0,1.5,1170,2.0,1070,100,2007
3606,288790.0,4.0,2.0,1350,3.0,1350,0,2008
3607,229800.0,2.0,1.75,1110,2.0,1110,0,2014
3608,516500.0,1.0,1.25,1100,3.0,1100,0,2014
3610,234000.0,3.0,1.0,1040,1.0,1040,0,1983
3611,230000.0,2.0,1.75,1910,2.0,1910,0,1980
3612,300000.0,4.0,1.0,1370,1.0,1370,0,1949
3613,470000.0,3.0,1.5,1500,1.5,1140,360,1927
3614,339900.0,3.0,1.0,1200,1.0,1200,0,1969
3615,650000.0,2.0,1.0,1050,1.0,880,170,1904
3616,585000.0,5.0,2.5,2670,1.5,1620,1050,1920
3617,699900.0,4.0,2.5,2190,1.0,1430,760,1972
3618,598000.0,4.0,2.5,3130,2.0,3130,0,1994
3619,475000.0,3.0,2.5,1700,1.0,1160,540,1998
3620,314500.0,3.0,1.75,1700,1.0,1200,500,1978
3621,397000.0,3.0,3.5,1360,2.0,1240,120,2007
3622,345000.0,3.0,2.0,1610,1.0,1610,0,1986
3623,325000.0,5.0,2.75,2130,1.0,1300,830,1991
3624,265000.0,3.0,1.0,1800,1.0,1800,0,1957
3625,402000.0,4.0,2.75,2950,1.0,2120,830,1974
3626,835000.0,3.0,2.25,2120,2.0,2120,0,1964
3627,780000.0,4.0,2.5,3500,2.0,3500,0,2005
3628,250000.0,3.0,2.0,1440,1.0,1440,0,1965
3629,1200000.0,4.0,2.0,2120,2.0,2120,0,1905
3630,935000.0,2.0,2.5,1780,2.0,1780,0,1974
3631,300000.0,2.0,1.0,960,1.0,960,0,1947
3632,419000.0,2.0,1.75,1510,1.0,1510,0,2006
3633,410000.0,1.0,1.5,1010,1.0,1010,0,1911
3634,1165000.0,3.0,3.0,3790,2.0,2810,980,1989
3635,461000.0,3.0,1.75,3600,2.0,2400,1200,1948
3636,385000.0,3.0,1.75,1300,1.0,1300,0,1968
3637,669500.0,4.0,2.25,2500,1.5,1520,980,1940
3638,491950.0,3.0,2.25,2090,1.0,1440,650,1958
3639,1230000.0,3.0,1.75,2200,1.5,2200,0,1948
3640,560000.0,3.0,2.25,2070,1.5,2070,0,1955
3641,370000.0,3.0,1.0,1320,1.0,1320,0,1982
3642,263400.0,4.0,2.0,1360,1.0,960,400,1960
3643,100000.0,2.0,1.0,930,1.0,930,0,1942
3644,289950.0,3.0,2.5,1760,1.5,1760,0,1937
3645,263000.0,3.0,1.75,1410,2.0,1410,0,1985
3646,397500.0,4.0,2.5,2570,2.0,2570,0,1992
3647,245000.0,3.0,2.75,1300,1.0,860,440,1996
3648,535000.0,3.0,1.0,1580,1.0,1180,400,1925
3649,449000.0,4.0,2.5,2960,2.0,2960,0,2005
3650,490000.0,4.0,3.0,2330,2.0,1920,410,2003
3651,445800.0,4.0,2.25,2070,1.0,1470,600,1977
3652,345000.0,2.0,1.0,970,1.0,970,0,1932
3653,327500.0,3.0,2.25,2310,2.0,2310,0,1990
3654,436500.0,4.0,2.5,2290,2.0,2290,0,1988
3655,550000.0,3.0,2.25,1720,1.0,1220,500,1967
3656,441000.0,2.0,1.5,1190,1.0,990,200,1919
3657,406500.0,2.0,1.0,870,1.0,870,0,1947
3658,243000.0,2.0,1.5,1068,2.0,1068,0,1990
3659,359500.0,4.0,2.75,2140,2.0,2140,0,1993
3660,760000.0,4.0,2.5,3300,2.0,3300,0,1984
3662,408000.0,5.0,3.25,2820,1.5,2320,500,1906
3663,480000.0,4.0,3.0,2440,2.0,1890,550,1981
3664,875000.0,4.0,1.5,1800,1.5,1800,0,1929
3665,308000.0,3.0,1.0,1010,1.0,1010,0,1954
3666,880000.0,4.0,2.75,3220,1.5,2320,900,1931
3668,170000.0,2.0,1.0,1200,2.0,1200,0,1976
3669,491500.0,3.0,2.25,1470,2.0,1470,0,1985
3670,515000.0,3.0,2.5,2600,2.0,2600,0,2003
3671,550000.0,4.0,1.5,2750,1.0,1500,1250,1958
3672,255000.0,2.0,1.0,1320,1.0,940,380,1919
3673,635000.0,3.0,2.5,3350,2.0,2550,800,2005
3674,850000.0,3.0,2.5,2650,2.0,1830,820,1920
3675,265000.0,2.0,2.0,1860,1.0,1260,600,1952
3676,349810.0,3.0,1.0,960,1.0,960,0,1958
3677,972000.0,4.0,1.75,2010,1.0,1610,400,1937
3678,235000.0,2.0,1.0,900,1.0,900,0,1928
3679,330000.0,4.0,2.5,2340,2.0,2340,0,1997
3680,500000.0,4.0,3.0,3720,3.0,3720,0,1979
3681,570000.0,3.0,2.0,1890,1.0,1470,420,1949
3682,1309500.0,4.0,2.5,2680,1.0,1590,1090,1956
3683,544000.0,3.0,2.5,1460,2.0,1180,280,2007
3684,439000.0,3.0,2.5,3180,1.0,1810,1370,2006
3685,530000.0,4.0,2.25,1980,2.0,1980,0,1981
3686,427500.0,2.0,2.0,1090,3.0,1090,0,2008
3687,337000.0,4.0,2.5,2230,2.0,2230,0,2002
3688,1095000.0,4.0,2.75,3330,2.0,3330,0,1995
3689,435000.0,4.0,2.0,1880,1.0,970,910,1904
3690,765000.0,5.0,3.0,2870,1.0,1950,920,1964
3691,492650.0,4.0,1.75,2120,1.0,1640,480,1967
3692,383962.0,4.0,2.5,2700,2.0,2700,0,2001
3693,950000.0,4.0,2.5,3670,2.5,3670,0,2007
3694,457000.0,3.0,2.5,1220,2.0,1010,210,2008
3696,882566.0,4.0,2.5,3560,3.0,3560,0,2014
3697,963000.0,4.0,3.25,3530,2.0,3530,0,2007
3698,345000.0,4.0,2.5,2280,2.0,2280,0,2006
3700,800000.0,3.0,3.5,3830,2.0,3530,300,1993
3701,314500.0,3.0,2.0,2050,1.0,2050,0,1993
3702,530000.0,3.0,2.5,3660,2.0,3260,400,1989
3703,650000.0,4.0,2.5,3350,2.0,3350,0,2004
3704,349500.0,3.0,2.0,1270,1.0,1270,0,1963
3705,1198000.0,4.0,3.5,3400,2.5,2790,610,2008
3706,165050.0,3.0,1.0,1200,1.0,1200,0,1959
3707,580000.0,3.0,2.5,2200,2.0,2200,0,1978
3708,330000.0,3.0,2.5,1680,1.0,1080,600,1959
3709,875000.0,5.0,3.5,3840,2.0,3840,0,2001
3710,500000.0,2.0,1.0,950,1.0,850,100,1926
3711,445000.0,4.0,2.5,2280,2.0,2280,0,1994
3712,274900.0,4.0,2.5,1970,2.0,1970,0,1987
3713,219950.0,3.0,1.5,1620,1.0,1620,0,1967
3714,691500.0,4.0,2.5,2600,2.0,2600,0,1962
3715,459500.0,2.0,1.0,1250,1.0,850,400,1929
3716,955500.0,4.0,1.75,2130,1.5,2130,0,1914
3717,328950.0,4.0,1.75,2550,1.0,1300,1250,1978
3718,307000.0,3.0,1.0,1150,1.5,1150,0,1927
3719,382500.0,3.0,1.75,1040,1.0,1040,0,1967
3720,1150000.0,4.0,2.5,3340,2.0,3340,0,1996
3722,478000.0,3.0,2.25,1640,2.0,1640,0,1994
3723,260000.0,2.0,1.0,770,1.0,770,0,1948
3725,616000.0,4.0,1.75,1700,1.0,1700,0,1957
3726,540000.0,3.0,1.75,2050,1.0,1400,650,1984
3727,300000.0,3.0,2.25,1660,2.0,1660,0,2001
3728,507500.0,3.0,1.75,1990,1.0,1190,800,1977
3730,241000.0,3.0,2.0,1770,1.0,1770,0,1986
3731,485000.0,3.0,2.25,2440,2.0,2090,350,1991
3732,695000.0,3.0,2.5,2620,2.0,2620,0,1998
3733,548000.0,4.0,2.5,2440,2.0,2440,0,1994
3734,345000.0,2.0,1.0,1080,1.0,1080,0,1955
3735,280000.0,3.0,1.0,1090,1.0,1090,0,1962
3736,450000.0,3.0,1.75,1400,1.0,1400,0,1963
3737,515000.0,3.0,2.5,2010,2.0,2010,0,1994
3738,1014250.0,3.0,1.0,1640,1.5,1500,140,1920
3739,739900.0,5.0,2.5,3290,2.0,3290,0,2004
3740,600000.0,2.0,2.5,2510,2.0,2510,0,1990
3741,370000.0,2.0,1.0,860,1.0,860,0,1952
3742,729032.0,4.0,2.5,2840,1.0,1780,1060,1977
3743,510000.0,3.0,1.75,1750,2.0,1750,0,1934
3744,425000.0,3.0,1.5,1300,1.0,1300,0,1964
3745,1080000.0,3.0,2.75,3890,2.0,3260,630,1967
3746,337000.0,3.0,2.25,1460,3.0,1460,0,2006
3747,563000.0,4.0,1.0,1410,1.5,1410,0,1911
3749,245000.0,3.0,2.0,1190,1.5,1190,0,1907
3750,590000.0,3.0,2.0,1410,1.0,910,500,1947
3751,695000.0,3.0,2.0,2500,1.5,1680,820,1922
3752,402500.0,2.0,1.0,800,1.0,800,0,1946
3753,435000.0,3.0,2.5,2530,2.0,2530,0,1993
3754,660000.0,3.0,2.0,2570,1.0,1970,600,1983
3755,300000.0,3.0,2.75,2090,1.0,1340,750,1987
3756,600000.0,5.0,2.25,2980,1.0,1580,1400,1960
3757,205000.0,3.0,1.75,1170,1.0,1170,0,1981
3758,357500.0,3.0,3.5,2080,2.0,2080,0,2004
3759,1110000.0,5.0,3.25,3350,2.0,2510,840,1997
3760,332888.0,2.0,2.5,1050,2.0,950,100,2007
3761,174000.0,2.0,1.0,900,1.0,900,0,1979
3762,515000.0,2.0,1.0,1050,1.0,1050,0,1907
3763,392000.0,5.0,2.25,3740,1.5,2240,1500,1958
3764,485000.0,4.0,1.75,1430,2.0,1430,0,1900
3765,217500.0,3.0,1.75,1400,1.0,1400,0,1984
3766,502000.0,3.0,2.25,1600,2.0,1600,0,1983
3767,820000.0,3.0,2.25,2880,2.0,2880,0,1989
3769,102500.0,2.0,1.0,820,1.0,820,0,1937
3771,540000.0,4.0,2.5,2180,1.0,1180,1000,1968
3772,600000.0,2.0,1.0,910,1.5,910,0,1900
3773,406000.0,4.0,1.0,1580,1.5,1580,0,1928
3774,620000.0,4.0,3.0,2130,1.0,1440,690,1948
3776,401000.0,3.0,2.0,1240,1.0,1000,240,1984
3777,725000.0,3.0,1.75,1860,2.0,1860,0,1959
3778,276000.0,1.0,0.75,370,1.0,370,0,1923
3779,500000.0,5.0,3.25,3130,2.0,2180,950,1975
3780,375000.0,3.0,1.75,2530,1.0,1800,730,1977
3782,260000.0,3.0,2.25,1920,1.0,1300,620,1961
3784,431000.0,4.0,2.5,2300,2.0,2300,0,2001
3785,321000.0,4.0,2.5,1830,2.0,1830,0,2003
3786,433000.0,4.0,1.5,1550,1.0,1180,370,1963
3788,482000.0,3.0,2.25,1710,2.0,1710,0,1989
3789,712000.0,3.0,2.5,2375,2.0,2375,0,2002
3790,505000.0,4.0,2.75,2200,1.0,1100,1100,1962
3792,452000.0,3.0,1.75,1110,1.0,1110,0,1966
3793,581000.0,4.0,1.0,1630,1.5,1630,0,1921
3794,952500.0,4.0,1.5,2550,2.0,2550,0,1910
3795,808000.0,4.0,2.25,2500,2.0,2500,0,1987
3796,476000.0,4.0,3.0,2890,1.0,1590,1300,1945
3797,535000.0,4.0,1.75,1420,1.5,1420,0,1945
3798,1356925.0,4.0,3.5,4270,2.0,3170,1100,1937
3799,629800.0,3.0,2.5,2390,2.0,2220,170,2008
3800,417838.0,4.0,2.5,2530,2.0,2530,0,2014
3801,399895.0,4.0,2.5,2701,2.0,2701,0,2014
3802,825000.0,4.0,2.75,3990,2.0,3990,0,2003
3803,300000.0,4.0,2.5,2303,2.0,2303,0,2006
3804,640000.0,2.0,2.25,1540,3.0,1540,0,2007
3805,460000.0,3.0,2.5,1450,2.0,940,510,2008
3806,525000.0,2.0,2.5,1160,2.0,1040,120,2012
3807,499990.0,4.0,2.75,2910,2.0,2910,0,2013
3808,1020000.0,4.0,3.5,3770,2.0,3770,0,2008
3809,675000.0,5.0,2.25,2900,1.0,1450,1450,1985
3810,512031.0,3.0,1.75,1540,1.0,770,770,1920
3811,310000.0,2.0,1.0,700,1.0,700,0,1918
3813,255000.0,4.0,2.0,2430,1.0,1430,1000,1960
3814,435000.0,3.0,2.5,1900,2.0,1900,0,1993
3815,453000.0,3.0,2.0,1660,1.0,1260,400,1983
3816,260000.0,4.0,2.0,1620,2.0,1620,0,1975
3817,659000.0,4.0,2.0,2090,1.0,2090,0,1951
3818,223000.0,3.0,2.0,1110,1.0,1110,0,1991
3819,851000.0,5.0,3.25,3760,2.0,2550,1210,1984
3820,605000.0,3.0,2.25,2080,1.0,1530,550,1973
3821,895000.0,4.0,2.25,1950,1.0,1330,620,1947
3822,519000.0,5.0,2.25,2570,1.0,1470,1100,1950
3823,535000.0,3.0,1.75,2330,1.0,1390,940,1983
3824,489000.0,3.0,3.0,3700,2.0,3700,0,1982
3825,250000.0,3.0,2.25,1920,1.0,1520,400,1965
3826,580000.0,3.0,2.25,1900,1.5,1200,700,1905
3827,1038000.0,4.0,1.75,1440,1.0,1440,0,1967
3828,605000.0,4.0,2.25,2940,1.0,1520,1420,1961
3829,599950.0,4.0,3.5,2500,2.0,1810,690,2008
3830,700000.0,3.0,2.5,2490,2.0,2490,0,1993
3831,480000.0,3.0,2.0,1470,1.0,1470,0,1956
3832,329950.0,4.0,2.5,2120,2.0,2120,0,2002
3833,250000.0,3.0,1.75,1200,1.0,1200,0,1984
3834,345000.0,5.0,2.5,2450,2.0,2450,0,2002
3835,175000.0,4.0,2.5,1780,2.0,1780,0,1991
3836,185000.0,5.0,1.0,1590,1.5,1090,500,1942
3837,411000.0,4.0,2.0,2370,2.0,2370,0,1978
3838,690000.0,3.0,1.5,1760,2.0,1760,0,1922
3839,265000.0,4.0,3.0,1940,1.0,1940,0,1948
3840,720000.0,4.0,3.0,3550,1.5,2180,1370,1990
3841,256000.0,4.0,2.5,2050,2.0,2050,0,2002
3842,255000.0,4.0,2.25,1680,2.0,1680,0,2002
3843,540000.0,3.0,2.25,1320,2.0,1320,0,1994
3844,481015.0,3.0,2.25,1550,2.0,1550,0,1987
3845,575000.0,3.0,1.75,2680,1.0,1590,1090,1974
3846,339950.0,3.0,2.5,2390,1.0,1840,550,1984
3847,475000.0,4.0,2.5,2040,2.0,2040,0,1963
3848,732000.0,3.0,3.75,2670,2.5,2020,650,1977
3849,860000.0,4.0,1.75,1880,1.5,1880,0,1924
3850,389000.0,4.0,1.75,2400,1.5,1500,900,1927
3851,645000.0,3.0,1.75,2270,1.0,1370,900,1956
3852,475000.0,4.0,2.5,1850,2.0,1850,0,1981
3853,550000.0,4.0,2.75,2160,1.0,1430,730,1987
3854,305000.0,2.0,1.0,2160,1.0,1360,800,1968
3855,782000.0,2.0,1.5,1570,1.5,1320,250,1906
3856,545000.0,3.0,2.0,1340,1.5,1340,0,1923
3857,394500.0,4.0,2.5,3002,2.0,3002,0,2004
3858,600000.0,5.0,2.0,2190,1.0,1110,1080,1965
3859,1300000.0,4.0,1.75,2610,1.0,2610,0,1966
3860,300000.0,2.0,1.0,1010,1.0,1010,0,1947
3861,330000.0,4.0,2.5,2105,2.0,2105,0,2003
3862,723000.0,4.0,2.25,2430,1.5,1630,800,1928
3864,480000.0,5.0,2.5,2160,2.0,2160,0,1998
3865,496000.0,2.0,1.0,900,1.0,900,0,1946
3866,625000.0,3.0,3.0,1820,3.0,1540,280,2006
3867,475000.0,4.0,2.0,2100,1.0,1050,1050,1962
3868,275250.0,3.0,2.25,1520,2.0,1520,0,1992
3869,253000.0,2.0,1.0,1310,1.0,940,370,1980
3870,630000.0,4.0,2.5,2190,1.0,1410,780,1979
3871,660500.0,5.0,2.5,2950,1.5,1720,1230,1918
3872,262000.0,5.0,1.0,1870,1.0,1580,290,1962
3874,552000.0,3.0,2.5,1840,1.0,1840,0,1978
3876,736000.0,2.0,1.0,1500,1.0,1100,400,1933
3877,355000.0,3.0,1.75,1730,1.5,1730,0,1954
3878,305000.0,3.0,1.0,1580,1.0,1010,570,1962
3879,484998.0,4.0,2.5,1540,2.0,1540,0,2014
3880,1054690.0,4.0,3.5,3390,2.0,2610,780,2014
3881,334500.0,2.0,1.5,830,2.0,830,0,2005
3882,475000.0,4.0,2.75,2620,2.0,2620,0,2013
3883,309780.0,3.0,2.5,2242,2.0,2242,0,2014
3884,795000.0,4.0,2.5,2890,2.0,2890,0,2005
3885,274500.0,3.0,2.25,1450,2.0,1450,0,2010
3886,265050.0,2.0,1.5,800,2.0,800,0,2008
3887,567500.0,3.0,2.5,2280,2.0,1880,400,2006
3889,285000.0,5.0,2.5,2270,2.0,2270,0,1995
3890,445838.0,3.0,2.5,2250,2.0,2250,0,2000
3891,304900.0,4.0,1.75,2600,1.0,1610,990,1969
3892,940000.0,4.0,2.0,2490,2.0,2490,0,1968
3893,1127000.0,4.0,2.5,3160,2.0,3160,0,1995
3895,290000.0,3.0,1.0,1440,1.0,1440,0,1967
3896,250000.0,3.0,1.75,1770,1.0,1770,0,1959
3897,342000.0,4.0,2.5,2300,2.0,2300,0,2001
3898,1012000.0,4.0,2.5,2980,2.0,2980,0,1989
3899,400000.0,4.0,2.25,2230,1.0,1300,930,1963
3900,312500.0,3.0,1.75,1830,1.0,930,900,1950
3901,267000.0,3.0,1.0,1740,1.0,1020,720,1962
3902,575000.0,3.0,1.75,1530,1.0,1410,120,1955
3903,810000.0,3.0,1.5,1520,1.0,1520,0,1954
3904,850000.0,3.0,2.5,3230,2.0,2430,800,1945
3905,1015000.0,3.0,3.25,3620,2.0,2730,890,2005
3907,240000.0,3.0,1.75,1570,1.0,1570,0,1960
3908,198000.0,4.0,1.75,2080,1.0,1050,1030,1966
3909,565000.0,4.0,2.5,2230,1.0,1430,800,1969
3910,1195000.0,5.0,3.0,3420,2.0,2540,880,1952
3912,815000.0,4.0,2.5,3150,2.0,3150,0,2002
3914,588000.0,5.0,3.0,2190,2.0,1490,700,1940
3915,280500.0,4.0,2.5,1890,2.0,1890,0,1997
3916,390000.0,4.0,2.0,1900,1.0,1900,0,2004
3917,509000.0,2.0,1.5,1930,2.0,1930,0,1989
3918,490600.0,3.0,2.5,3316,2.0,3316,0,1986
3919,650000.0,3.0,1.5,1380,1.0,1380,0,1960
3920,715000.0,3.0,4.0,2080,3.0,2080,0,1997
3921,529950.0,3.0,1.0,1240,1.5,1240,0,1909
3922,265000.0,3.0,1.0,1020,1.0,1020,0,1959
3924,1140000.0,3.0,2.5,2780,1.5,2110,670,1969
3925,610000.0,3.0,2.0,2300,1.0,1430,870,1955
3926,554729.0,4.0,2.5,2020,2.0,1730,290,1943
3927,395000.0,5.0,1.75,1840,1.0,1360,480,1948
3928,341000.0,3.0,1.0,1390,1.5,1390,0,1908
3929,264500.0,4.0,2.25,2060,1.0,1200,860,1962
3930,395000.0,4.0,2.75,2640,1.5,2640,0,1963
3931,640000.0,3.0,2.25,1980,1.0,1980,0,1959
3932,430000.0,3.0,1.5,1810,1.0,1030,780,1958
3933,410000.0,4.0,2.5,1700,1.0,1700,0,1972
3934,220000.0,4.0,1.0,1200,1.5,1200,0,1923
3936,405500.0,2.0,2.75,1350,2.0,1120,230,2006
3937,633000.0,4.0,2.5,2360,1.0,1980,380,1977
3938,295950.0,2.0,1.0,1190,1.0,1190,0,1948
3940,605000.0,4.0,2.5,2800,1.0,1420,1380,1970
3941,255000.0,2.0,1.5,920,2.0,920,0,1995
3942,474000.0,3.0,1.75,1530,2.0,1530,0,1978
3943,370000.0,2.0,1.0,860,1.0,860,0,1956
3944,288000.0,3.0,2.5,1520,2.0,1520,0,2004
3945,100000.0,2.0,0.75,660,1.0,660,0,1912
3946,1150000.0,5.0,2.5,3580,2.0,3580,0,2000
3947,600000.0,5.0,2.25,3000,2.0,3000,0,1975
3948,515000.0,5.0,3.25,2740,1.0,1390,1350,1977
3949,345000.0,4.0,2.5,2040,2.0,2040,0,1999
3951,850000.0,3.0,2.0,2470,2.0,2470,0,1961
3952,439990.0,3.0,2.5,1930,2.0,1300,630,2005
3953,554950.0,3.0,2.5,2950,2.0,2950,0,2006
3954,605000.0,3.0,2.5,2610,2.0,2610,0,2001
3955,609000.0,3.0,1.75,1630,3.0,1630,0,2014
3956,425000.0,3.0,1.5,1400,3.0,1400,0,2007
3957,399900.0,2.0,1.75,1410,1.5,900,510,2011
3960,519995.0,4.0,3.0,2590,2.0,2590,0,2014
3961,625000.0,3.0,1.5,1300,1.0,1300,0,1960
3962,600000.0,3.0,2.5,2320,2.0,2320,0,2003
3963,1200000.0,4.0,2.5,2700,2.0,2700,0,2004
3965,671000.0,4.0,3.0,3130,1.5,1750,1380,1953
3966,459500.0,3.0,1.75,1470,1.0,1030,440,1984
3967,499000.0,3.0,2.5,1540,3.0,1390,150,1995
3968,1280000.0,4.0,2.5,3160,1.5,2020,1140,1917
3969,395000.0,3.0,1.75,1480,1.0,1480,0,1975
3970,861990.0,5.0,2.75,3595,2.0,3595,0,2014
3971,382500.0,2.0,1.0,1190,1.0,1190,0,1981
3972,404950.0,4.0,2.25,2340,1.0,2340,0,1982
3973,530000.0,3.0,1.75,1320,1.0,870,450,1918
3974,195000.0,2.0,1.0,1190,1.0,1190,0,1910
3975,747500.0,4.0,2.25,2350,2.0,2350,0,1977
3976,199990.0,3.0,1.0,1100,1.0,1100,0,1961
3977,548800.0,4.0,1.0,1660,1.5,1260,400,1930
3978,870000.0,4.0,3.0,3040,1.5,2680,360,1923
3979,588000.0,3.0,2.0,1860,2.0,1860,0,1908
3982,445000.0,2.0,2.0,1240,2.0,1240,0,1985
3983,300000.0,4.0,3.0,2200,1.0,2200,0,1960
3984,480000.0,3.0,2.25,1680,1.0,1130,550,1959
3985,300000.0,3.0,1.0,930,1.5,930,0,1919
3986,360000.0,3.0,1.5,1800,2.0,1800,0,1931
3988,875000.0,3.0,1.5,1820,1.0,1820,0,1952
3989,266000.0,4.0,2.25,1995,2.0,1995,0,1981
3990,866000.0,4.0,3.25,3990,2.0,3990,0,2004
3991,335950.0,2.0,1.5,800,1.0,800,0,1951
3992,215000.0,3.0,1.0,960,1.0,960,0,1967
3993,481000.0,4.0,2.5,2286,2.0,2286,0,2002
3994,320000.0,3.0,1.75,2220,1.0,1270,950,1950
3995,295000.0,3.0,1.75,1940,1.5,1940,0,1918
3996,295000.0,3.0,1.5,1640,2.0,1640,0,1908
3997,320000.0,3.0,1.0,1120,1.0,1120,0,1969
3998,780000.0,4.0,2.0,2600,1.0,1400,1200,1953
3999,437500.0,3.0,2.0,1490,2.0,1490,0,1948
4000,443000.0,5.0,1.75,1650,1.5,1650,0,1902
4001,575000.0,4.0,2.5,2400,2.0,2400,0,1990
4002,245000.0,2.0,1.0,1500,1.0,1190,310,1926
4003,450000.0,3.0,2.5,1990,2.0,1990,0,1993
4004,536000.0,2.0,1.5,1130,2.0,1030,100,2009
4005,685000.0,3.0,3.25,2030,2.0,2030,0,1980
4006,373000.0,4.0,1.75,1590,2.0,1590,0,1960
4007,450000.0,3.0,1.75,1480,1.0,1480,0,1971
4008,645000.0,4.0,2.5,2690,2.0,2690,0,1985
4009,1275000.0,3.0,2.5,3870,2.0,3870,0,1997
4010,230000.0,3.0,1.0,1390,1.0,1390,0,1954
4011,593000.0,3.0,2.75,1830,2.0,1690,140,2011
4012,558000.0,2.0,2.0,1580,1.0,790,790,1910
4013,538250.0,3.0,2.25,2590,2.0,2590,0,1984
4014,475000.0,5.0,2.5,2510,1.0,1490,1020,1977
4015,209950.0,3.0,1.5,1180,1.0,1180,0,1968
4016,410000.0,3.0,2.25,1450,2.0,1450,0,1989
4018,670000.0,5.0,2.5,2860,2.0,2860,0,1958
4019,821000.0,3.0,2.75,2760,1.0,1690,1070,1967
4020,665000.0,5.0,2.0,2800,1.0,1400,1400,1963
4021,339000.0,3.0,2.5,1450,2.0,1450,0,2004
4022,631500.0,4.0,2.0,2530,1.5,1910,620,1910
4023,570000.0,3.0,2.0,1640,1.0,820,820,1924
4024,437000.0,3.0,1.75,2220,1.0,2220,0,1967
4025,542500.0,3.0,2.5,2040,2.0,2040,0,1987
4026,229500.0,3.0,1.0,1230,1.0,1230,0,1967
4027,170500.0,2.0,1.0,1060,1.0,820,240,1981
4028,391500.0,3.0,2.5,1920,2.0,1920,0,1993
4029,296475.0,3.0,2.5,1520,2.0,1520,0,2004
4031,888550.0,3.0,2.5,3540,2.0,3540,0,1989
4033,328000.0,3.0,2.0,2250,1.5,2250,0,1998
4034,300000.0,4.0,2.5,2090,2.0,2090,0,2007
4035,500000.0,3.0,2.5,1720,2.0,1720,0,2011
4036,494815.0,3.0,2.5,1910,2.0,1910,0,2014
4037,378000.0,3.0,2.5,1601,3.0,1536,65,2007
4038,505000.0,2.0,2.25,1060,2.0,940,120,2006
4039,680000.0,4.0,2.75,2330,2.0,2330,0,2005
4040,351999.0,3.0,2.5,2370,2.0,2370,0,2014
4041,510000.0,3.0,2.5,1420,3.0,1420,0,2014
4042,1300000.0,4.0,2.25,2360,2.0,2360,0,2013
4043,374000.0,2.0,1.5,1260,2.0,1260,0,2001
4044,509900.0,3.0,2.5,3030,2.0,3030,0,2009
4045,230000.0,3.0,1.75,1140,2.0,1140,0,2014
4046,527700.0,5.0,2.5,2820,1.0,1550,1270,1968
4047,438000.0,2.0,2.0,1270,3.0,1270,0,2000
4048,900000.0,3.0,2.5,3180,2.0,3180,0,1978
4049,1131000.0,3.0,2.25,2790,1.0,2790,0,2006
4050,439000.0,4.0,2.25,2570,2.0,2570,0,1980
4051,315000.0,2.0,1.0,1080,1.0,720,360,1919
4052,765000.0,4.0,4.0,3010,2.0,3010,0,2004
4053,332000.0,3.0,2.25,2120,1.0,1720,400,1979
4054,600000.0,3.0,2.25,1900,1.5,1440,460,1969
4055,378500.0,3.0,2.5,2860,2.0,2860,0,1990
4056,190000.0,3.0,1.0,910,1.0,910,0,1968
4057,645000.0,4.0,2.5,2850,2.0,2850,0,1987
4058,780000.0,2.0,2.5,2560,2.0,1690,870,1901
4059,370000.0,3.0,1.75,1570,2.0,1570,0,1982
4060,875000.0,4.0,3.5,3110,2.0,3110,0,1979
4062,479000.0,3.0,1.0,1340,1.0,1340,0,1955
4063,245000.0,4.0,2.25,2600,1.0,1390,1210,1978
4064,542000.0,3.0,1.75,1070,1.0,1070,0,1966
4065,557500.0,3.0,2.25,1820,2.0,1820,0,1984
4066,480000.0,2.0,1.0,1060,1.0,860,200,1924
4067,330000.0,3.0,2.25,2220,1.0,1330,890,1993
4068,160000.0,3.0,1.0,1350,1.5,1350,0,1942
4069,695500.0,5.0,2.75,2510,1.0,1600,910,1975
4070,235500.0,5.0,2.5,2340,1.0,1670,670,1967
4071,326500.0,3.0,1.0,1060,1.0,1060,0,1968
4072,300000.0,4.0,2.5,2200,2.0,2200,0,1998
4073,267000.0,3.0,1.0,1400,1.5,1400,0,1944
4074,292600.0,3.0,1.5,1520,1.0,1520,0,1959
4075,362000.0,5.0,3.0,1810,2.0,1810,0,1998
4076,1087500.0,2.0,2.0,2360,1.5,2360,0,1997
4077,357562.0,2.0,1.75,1210,2.0,1210,0,2014
4079,513000.0,3.0,2.5,1810,2.0,1810,0,1992
4080,336000.0,3.0,2.25,2760,1.0,2760,0,1969
4081,560000.0,4.0,2.25,1950,1.0,1330,620,1968
4082,1150000.0,3.0,2.5,3830,2.0,3830,0,1991
4083,410000.0,4.0,2.25,2060,1.0,1220,840,1963
4084,371500.0,3.0,1.0,1650,1.0,980,670,1954
4085,368000.0,4.0,1.75,2100,1.0,1030,1070,1964
4087,308950.0,4.0,2.5,1920,2.0,1920,0,1994
4088,440000.0,3.0,2.0,1860,2.0,1860,0,1998
4089,630000.0,2.0,2.5,2290,2.0,2290,0,2005
4090,228950.0,3.0,1.75,1200,1.0,1200,0,1968
4092,245000.0,3.0,2.5,1600,2.0,1600,0,1992
4093,410000.0,4.0,2.5,2560,2.0,2560,0,2006
4094,427550.0,2.0,1.0,880,1.0,880,0,1940
4095,235000.0,2.0,1.0,1020,1.0,1020,0,1939
4096,210000.0,3.0,2.0,960,1.0,960,0,1949
4097,485000.0,4.0,2.25,1900,1.0,1370,530,1977
4098,410000.0,3.0,2.0,1320,1.5,1320,0,1920
4099,435000.0,4.0,2.75,2230,1.0,1320,910,1998
4100,300000.0,3.0,1.0,1150,1.0,1150,0,1960
4101,455000.0,4.0,3.5,3440,2.0,3440,0,2002
4102,210000.0,3.0,1.0,1070,1.0,1070,0,1949
4103,1050000.0,4.0,2.75,2250,1.5,1500,750,1927
4104,458400.0,4.0,2.5,1910,1.0,1910,0,1921
4105,390000.0,3.0,1.75,1180,1.0,1180,0,1967
4106,148226.0,3.0,1.0,1400,1.0,1400,0,1968
4107,711600.0,4.0,3.0,3580,2.5,2370,1210,1991
4108,819000.0,3.0,2.75,3176,2.0,2726,450,1985
4109,613000.0,2.0,2.0,1170,1.5,1170,0,1927
4110,592350.0,2.0,2.0,1570,1.0,1570,0,2006
4111,232000.0,3.0,1.5,1460,1.0,1460,0,1966
4112,250000.0,3.0,1.75,1140,1.0,1140,0,1983
4113,115000.0,1.0,2.0,1150,1.0,1150,0,1962
4114,1115000.0,4.0,2.5,3180,1.0,2390,790,1978
4115,585000.0,4.0,2.5,2630,2.0,2630,0,1999
4116,580000.0,3.0,2.25,1940,1.0,1520,420,1987
4117,165000.0,1.0,1.0,850,1.0,850,0,1906
4118,430000.0,3.0,2.0,1550,1.0,830,720,1942
4119,383000.0,3.0,2.25,2090,1.0,2090,0,1961
4120,1195000.0,4.0,3.5,3960,2.0,2850,1110,2006
4121,201500.0,3.0,1.0,1320,1.5,1320,0,1912
4122,690000.0,4.0,2.5,3220,2.0,3220,0,1991
4123,325000.0,2.0,1.0,800,1.0,800,0,1953
4124,375000.0,3.0,1.75,1660,1.0,1130,530,1976
4125,600000.0,4.0,2.5,2250,2.0,2250,0,1991
4126,340000.0,3.0,2.25,2120,1.0,2120,0,1997
4127,890000.0,4.0,2.75,2310,3.0,2310,0,1979
4128,415000.0,4.0,1.75,1920,2.0,1920,0,1970
4129,255000.0,3.0,1.75,1550,1.0,1050,500,1976
4130,530000.0,2.0,2.5,1785,2.0,1595,190,1975
4131,468000.0,3.0,1.5,1830,1.0,1830,0,1962
4132,970000.0,5.0,2.75,3500,2.0,2950,550,1927
4133,599000.0,3.0,2.0,2560,1.0,1330,1230,1987
4134,399500.0,4.0,1.75,1360,1.5,1360,0,1928
4136,1205000.0,4.0,3.5,3150,2.0,3150,0,2014
4137,325000.0,2.0,1.0,810,1.0,810,0,1941
4139,568000.0,4.0,1.75,2790,1.0,1450,1340,1956
4140,517000.0,2.0,1.5,1920,1.0,960,960,1912
4141,469950.0,4.0,2.75,2530,2.0,2530,0,1997
4144,623000.0,3.0,1.75,2050,1.0,2050,0,1973
4145,720000.0,4.0,2.25,2410,2.0,2410,0,1965
4146,205000.0,3.0,1.0,1180,1.0,1180,0,1967
4147,148000.0,2.0,1.0,630,1.0,630,0,1930
4149,405000.0,3.0,1.5,1010,1.5,1010,0,1953
4150,293000.0,3.0,2.25,1910,2.0,1910,0,2009
4151,550000.0,3.0,3.5,2490,2.0,1720,770,2005
4152,435000.0,4.0,2.5,2150,2.0,2150,0,2010
4153,355000.0,4.0,2.75,3000,2.0,3000,0,2005
4154,673000.0,3.0,2.75,2830,2.0,2830,0,2012
4155,449990.0,4.0,2.5,2680,2.0,2680,0,2013
4156,249000.0,2.0,1.5,1090,2.0,1090,0,1982
4157,380000.0,4.0,2.5,1984,1.0,1564,420,1962
4158,760005.0,4.0,2.75,3090,2.0,3090,0,2010
4159,674600.0,4.0,2.5,2610,2.0,2610,0,2006
4160,812000.0,4.0,3.5,3370,2.0,2750,620,2007
4161,333490.0,4.0,2.5,2250,2.0,2250,0,2014
4162,320000.0,3.0,3.25,1450,2.0,1180,270,2013
4163,999000.0,4.0,2.5,3130,2.0,3130,0,2013
4164,810000.0,2.0,2.75,2700,1.0,2700,0,2007
4165,399950.0,5.0,2.75,1970,1.0,1320,650,1986
4166,550000.0,3.0,2.0,1970,2.0,1270,700,1929
4167,290000.0,3.0,1.5,1950,1.0,1950,0,1959
4168,232500.0,3.0,1.5,1940,1.0,1140,800,1969
4169,1355000.0,4.0,3.5,3550,1.0,2260,1290,1999
4170,565000.0,3.0,2.5,2500,2.0,2500,0,1990
4171,749950.0,4.0,2.75,2910,1.0,2210,700,1957
4172,720500.0,4.0,2.5,3350,2.0,3350,0,1985
4173,507000.0,3.0,1.75,2140,1.0,1490,650,1950
4175,463000.0,4.0,2.5,1980,2.0,1980,0,1974
4176,310000.0,3.0,1.5,1460,1.0,1460,0,1952
4177,284000.0,4.0,1.75,1880,1.0,1130,750,1960
4178,737500.0,3.0,1.75,2320,2.0,2320,0,1935
4179,569000.0,3.0,3.25,2220,1.5,1770,450,1929
4180,700000.0,3.0,1.0,1410,2.0,1410,0,1901
4181,660000.0,3.0,1.0,1240,1.0,1240,0,1927
4182,275000.0,4.0,2.0,2030,2.0,2030,0,1944
4184,150000.0,3.0,0.75,490,1.5,490,0,1959
4185,356000.0,3.0,2.5,1590,2.0,1590,0,2000
4186,610000.0,3.0,2.5,2630,2.0,2630,0,2001
4187,498800.0,2.0,1.75,1350,1.0,1350,0,2008
4188,226550.0,3.0,1.0,990,1.0,990,0,1943
4189,692500.0,4.0,2.75,3710,2.0,3710,0,1999
4190,250000.0,3.0,1.0,990,1.0,990,0,1960
4191,660000.0,4.0,2.5,2510,2.0,2510,0,2002
4192,295000.0,2.0,1.0,800,1.0,800,0,1953
4193,154950.0,4.0,1.0,1600,1.0,1600,0,1966
4194,409124.0,5.0,3.25,3320,2.0,2480,840,1999
4195,287000.0,5.0,1.5,1730,1.0,1010,720,1962
4196,810000.0,4.0,1.75,2000,1.0,1000,1000,1958
4197,525000.0,4.0,2.75,2910,1.0,1640,1270,1985
4198,525000.0,4.0,1.75,1710,1.0,1710,0,1955
4199,275000.0,3.0,1.0,1200,1.0,1200,0,1954
4200,583000.0,3.0,2.5,2600,2.0,2600,0,1998
4201,237950.0,2.0,1.75,1460,1.0,1460,0,1987
4203,679000.0,4.0,2.75,2100,1.5,1780,320,1928
4205,410000.0,3.0,1.75,1660,1.0,830,830,1980
4206,306000.0,3.0,1.0,1450,1.0,1010,440,1969
4207,215000.0,4.0,1.5,1860,1.5,1860,0,1920
4208,594950.0,4.0,2.5,2720,2.0,2720,0,1989
4209,1250000.0,4.0,2.5,2920,1.0,2030,890,1957
4210,305000.0,3.0,1.5,1800,1.0,1800,0,1966
4211,425000.0,2.0,1.0,1320,1.0,1020,300,1939
4212,215000.0,3.0,1.75,1770,1.0,1770,0,1959
4213,480000.0,5.0,2.75,2550,1.0,1390,1160,1967
4214,550000.0,4.0,1.75,2150,1.0,1110,1040,1966
4215,750000.0,4.0,2.5,3020,2.0,3020,0,2004
4216,137124.0,3.0,1.0,960,1.0,960,0,1970
4217,840000.0,3.0,2.0,2783,2.0,2783,0,1910
4218,624800.0,3.0,2.0,2250,1.0,1500,750,1964
4219,630000.0,3.0,1.75,1710,1.0,1710,0,1986
4220,590000.0,3.0,2.5,2650,1.0,1680,970,1975
4221,599950.0,3.0,3.25,1830,3.0,1830,0,2014
4222,299880.0,3.0,2.5,1460,2.0,1460,0,2000
4223,400000.0,3.0,2.0,1760,1.0,1760,0,1967
4224,560000.0,3.0,2.5,1960,2.0,1960,0,2002
4225,229000.0,4.0,2.25,2010,1.0,1170,840,1979
4226,525000.0,4.0,2.5,3670,2.0,3670,0,2005
4227,737000.0,2.0,2.25,2290,1.0,2290,0,2007
4228,680000.0,3.0,2.0,1780,1.0,980,800,1925
4229,635000.0,4.0,2.5,3080,2.0,3080,0,1997
4230,740000.0,4.0,2.5,3360,2.0,3360,0,1997
4231,335500.0,3.0,1.0,1370,2.0,1370,0,1930
4232,270000.0,4.0,2.5,1660,1.0,1660,0,1978
4234,450000.0,5.0,2.5,2850,1.0,1930,920,1925
4235,379000.0,3.0,2.5,1530,2.0,1530,0,1986
4236,468000.0,4.0,2.5,2100,1.0,1240,860,1976
4237,321500.0,1.0,1.0,730,1.0,730,0,2008
4238,443000.0,3.0,2.25,1920,2.0,1920,0,1989
4239,340000.0,3.0,1.0,1600,1.0,1600,0,1958
4240,470000.0,4.0,2.25,2380,2.0,1530,850,1979
4241,545000.0,3.0,2.5,2760,2.0,2760,0,2002
4242,415000.0,4.0,1.5,1840,1.5,1840,0,1950
4244,759000.0,4.0,1.75,2100,1.0,1340,760,1975
4245,300000.0,4.0,1.75,1820,1.0,1190,630,1926
4247,359000.0,3.0,1.5,1550,1.0,1080,470,1978
4248,550000.0,4.0,1.0,1440,1.5,1440,0,1924
4249,395000.0,2.0,1.0,930,1.0,930,0,1940
4250,486000.0,4.0,2.5,3560,2.0,3560,0,1988
4251,187000.0,2.0,1.0,840,1.0,840,0,1952
4252,734950.0,4.0,3.25,4280,2.0,3050,1230,2002
4253,284000.0,3.0,1.5,1500,1.0,1500,0,1957
4254,696000.0,4.0,3.5,3650,2.0,2550,1100,1996
4255,380000.0,2.0,1.0,780,1.0,780,0,1918
4256,625000.0,4.0,1.0,1600,1.5,1600,0,1946
4257,252000.0,4.0,1.75,1120,1.0,1120,0,1966
4258,560000.0,2.0,1.0,1010,1.0,1010,0,1960
4259,395000.0,4.0,2.75,1970,1.0,1970,0,1961
4260,900000.0,4.0,2.5,2230,2.0,1540,690,1935
4262,625000.0,3.0,1.75,3160,1.0,2160,1000,1978
4263,580000.0,3.0,1.75,1850,1.0,1020,830,1909
4264,309000.0,3.0,2.25,1980,1.0,1300,680,1963
4265,412000.0,4.0,3.5,3360,2.0,2450,910,1990
4266,495000.0,3.0,2.0,2660,1.0,2660,0,1964
4267,215000.0,3.0,1.0,1200,1.0,1200,0,1967
4268,741500.0,2.0,2.5,2150,1.0,2150,0,2010
4269,749000.0,3.0,2.75,2820,2.0,2820,0,2008
4270,659950.0,4.0,2.75,3510,2.0,3510,0,2014
4271,530000.0,3.0,2.5,1790,2.0,1790,0,2010
4272,749000.0,4.0,2.75,2700,2.0,2100,600,1910
4274,595000.0,4.0,3.25,3730,2.0,2760,970,2013
4275,487000.0,4.0,2.5,2540,2.0,2540,0,2005
4276,760000.0,4.0,2.25,3300,3.0,3300,0,2014
4278,435000.0,4.0,2.5,2550,2.0,2550,0,2009
4279,374950.0,3.0,2.25,1390,3.0,1390,0,2007
4280,440000.0,3.0,1.5,1270,3.0,1270,0,2007
4281,360000.0,4.0,2.5,2380,2.0,2380,0,2005
4282,879000.0,4.0,2.5,3360,2.0,3360,0,1994
4284,505000.0,2.0,1.0,1240,1.0,1240,0,1962
4285,545000.0,2.0,2.0,2930,1.0,1680,1250,1980
4286,600000.0,2.0,2.5,2410,1.0,1940,470,1912
4288,725000.0,2.0,1.75,1950,1.0,1010,940,1919
4289,610000.0,4.0,2.75,2600,1.0,1580,1020,1976
4290,350000.0,4.0,1.0,1170,1.5,1170,0,1959
4291,410000.0,3.0,1.0,1470,1.0,1470,0,1953
4292,639000.0,4.0,2.0,1840,1.0,920,920,1942
4293,439000.0,4.0,2.0,1560,1.0,1560,0,1968
4294,499950.0,4.0,1.75,1520,1.0,1520,0,1967
4295,800000.0,3.0,2.75,2220,2.0,1700,520,1914
4296,350000.0,4.0,2.5,2800,2.0,2800,0,1993
4297,279000.0,2.0,1.0,670,1.0,670,0,1942
4298,290256.0,3.0,2.25,1720,2.0,1720,0,1983
4299,355000.0,3.0,2.5,2110,2.0,2110,0,1989
4300,263000.0,3.0,1.75,1580,1.0,1180,400,1993
4302,426500.0,4.0,2.5,2700,2.0,2700,0,1998
4303,735000.0,3.0,2.5,2820,2.0,2820,0,2004
4304,720000.0,4.0,2.5,3340,2.0,3340,0,1999
4305,265000.0,3.0,2.5,1530,2.0,1530,0,1991
4306,840000.0,4.0,3.5,3840,2.0,3840,0,1998
4307,657500.0,3.0,2.0,2320,1.0,1510,810,1956
4308,850000.0,5.0,2.0,2310,1.5,2310,0,1966
4309,436110.0,3.0,2.5,1770,3.0,1600,170,2007
4310,589900.0,2.0,3.0,3160,2.0,3160,0,1993
4311,620000.0,3.0,1.5,1620,1.0,1280,340,1954
4312,254000.0,4.0,2.0,1510,1.0,1510,0,1955
4313,375000.0,3.0,1.75,960,1.0,960,0,1962
4314,455000.0,4.0,2.25,1740,1.0,1170,570,1958
4315,445000.0,4.0,2.0,1470,1.0,1470,0,1965
4316,568500.0,4.0,2.5,2460,2.0,2460,0,1998
4317,352500.0,3.0,1.75,1170,1.0,1170,0,1962
4318,342500.0,2.0,1.75,1210,1.0,1210,0,1982
4319,299950.0,3.0,2.5,1870,2.0,1870,0,1990
4320,425000.0,3.0,2.5,1950,2.0,1950,0,2009
4321,561000.0,4.0,2.5,2570,2.0,2570,0,1990
4322,455500.0,3.0,2.0,1460,1.0,1460,0,1975
4323,400000.0,3.0,2.5,2970,1.0,1510,1460,1967
4324,443500.0,4.0,2.5,2040,2.0,2040,0,1994
4325,1234582.0,5.0,3.25,3240,1.5,2500,740,1939
4326,370000.0,4.0,2.75,3150,1.0,2250,900,1965
4327,475000.0,3.0,2.25,1820,1.0,1240,580,1981
4328,580000.0,4.0,2.5,2130,1.0,1490,640,1980
4329,518000.0,3.0,1.5,1430,1.0,1430,0,1956
4330,525000.0,3.0,2.5,2030,2.0,2030,0,1991
4331,236000.0,4.0,2.75,2000,2.0,2000,0,1997
4332,278500.0,4.0,2.25,1940,2.0,1940,0,1990
4333,205425.0,2.0,1.75,880,1.0,880,0,1945
4334,248000.0,3.0,1.0,950,1.0,950,0,1954
4335,505000.0,3.0,2.25,1670,2.0,1220,450,2002
4336,657500.0,3.0,2.5,2670,2.0,2670,0,1989
4337,670000.0,3.0,2.5,2700,2.0,1280,1420,2003
4338,202000.0,1.0,1.0,590,1.0,590,0,1926
4339,440000.0,4.0,2.25,2160,1.0,1080,1080,1966
4340,690000.0,4.0,2.5,2700,2.0,2700,0,2004
4342,291000.0,3.0,1.75,1560,1.0,1560,0,1964
4343,230000.0,3.0,1.75,1400,1.0,1400,0,1957
4344,850000.0,4.0,3.25,3090,2.0,3090,0,2013
4345,84350.0,4.0,2.0,2630,2.0,2630,0,1953
4349,188000.0,4.0,2.75,3260,1.0,2170,1090,1968
4351,7800.0,2.0,1.0,780,1.0,780,0,1942
4352,237227.857143,4.0,2.5,2200,2.0,2200,0,1987
4353,117833.333333,3.0,1.0,1340,1.0,1340,0,1953
4354,0.0,3.0,1.75,1490,1.0,1490,0,1962
4355,744312.5,4.0,2.5,2800,1.0,1660,1140,1963
4356,0.0,4.0,2.75,2600,1.0,1300,1300,1960
4358,0.0,5.0,3.5,3480,2.0,2490,990,1983
4359,439333.333333,3.0,3.5,3020,2.0,2080,940,1954
4360,280000.0,3.0,2.25,1970,1.0,1180,790,1967
4361,0.0,5.0,1.5,1500,1.0,760,740,1920
4362,0.0,4.0,4.0,3680,2.0,3680,0,1990
4363,176225.0,3.0,2.0,1570,1.0,1570,0,1952
4364,500324.0,3.0,2.5,2280,2.0,1880,400,2006
4365,444845.0,3.0,2.5,1600,2.0,1600,0,2013
4366,330000.0,3.0,3.0,1680,3.0,1680,0,2014
4367,292285.714286,3.0,1.75,1890,1.0,1890,0,1966
4368,160000.0,2.0,1.0,520,1.0,520,0,1951
4369,274333.333333,3.0,2.25,1780,2.0,1780,0,1988
4370,537500.0,4.0,3.0,2920,1.0,1460,1460,1964
4371,232333.333333,3.0,2.25,2430,1.0,2430,0,1974
4372,237333.333333,3.0,2.75,3010,2.0,3010,0,2011
4373,346750.0,3.0,1.0,1620,1.5,1620,0,1911
4374,0.0,2.0,2.5,2200,1.0,2200,0,2007
4375,1020000.0,3.0,2.25,2950,1.5,2950,0,2006
4376,0.0,4.0,2.25,2170,1.0,1270,900,1960
4377,254000.0,3.0,1.5,1770,1.0,1160,610,1959
4378,238750.0,3.0,1.0,1830,1.0,1830,0,1942
4379,268971.875,4.0,2.5,2380,2.0,2380,0,1997
4380,642000.0,4.0,2.5,2550,1.0,1290,1260,1964
4381,571986.111111,3.0,2.5,3720,2.0,3720,0,1982
4384,554250.0,3.0,2.5,1490,3.0,1490,0,2004
4386,0.0,4.0,1.5,2180,1.0,1280,900,1954
4387,107500.0,4.0,1.5,1590,1.0,1590,0,1966
4388,300000.0,3.0,2.0,1510,1.0,1230,280,1973
4390,540833.333333,3.0,2.0,1640,1.0,1640,0,1977
4391,274750.0,4.0,2.5,1840,2.0,1400,440,2004
4392,148612.5,3.0,1.0,1040,1.0,1040,0,1959
4393,326428.571429,3.0,1.0,1250,1.0,1250,0,1951
4394,0.0,5.0,3.25,3690,2.0,3690,0,1977
4395,135333.333333,4.0,1.0,1530,1.5,1400,130,1948
4396,577437.5,4.0,2.5,2110,2.0,2110,0,2000
4397,440825.0,3.0,1.75,2150,1.0,1200,950,1956
4399,257500.0,4.0,1.75,2420,1.0,1480,940,1979
4401,176400.0,2.0,1.0,910,1.0,910,0,1981
4402,193000.0,3.0,1.5,2200,1.5,2200,0,1932
4403,646212.5,4.0,2.5,3430,2.0,3430,0,2013
4404,268971.875,4.0,2.5,1860,1.0,1220,640,1983
4405,0.0,4.0,3.75,3300,1.5,2600,700,1926
4406,317061.875,3.0,1.75,1280,1.0,1280,0,1969
4407,83300.0,3.0,2.0,1490,1.0,1490,0,1990
4408,0.0,5.0,2.25,2880,2.0,2880,0,1990
4409,266066.666667,4.0,1.0,1310,1.5,1160,150,1945
4410,342246.428571,4.0,2.5,1980,2.0,1980,0,1988
4411,0.0,5.0,2.25,2000,1.0,1300,700,1986
4412,0.0,3.0,3.0,1860,1.0,1040,820,1954
4413,0.0,4.0,3.0,1990,2.0,1990,0,1990
4414,240015.333333,4.0,2.25,1720,1.0,1720,0,1973
4415,83300.0,3.0,2.0,1370,1.0,1370,0,1964
4417,259585.571429,4.0,2.5,1960,2.0,1960,0,2001
4418,328211.904762,4.0,2.5,1720,1.0,1120,600,1961
4419,673476.818182,4.0,2.5,2740,2.0,2740,0,1990
4420,0.0,4.0,1.0,1360,1.0,1360,0,1955
4421,425000.0,3.0,2.5,1870,2.0,1870,0,2003
4422,127160.0,2.0,1.0,720,1.0,720,0,1942
4423,341750.0,3.0,2.25,2180,2.0,2180,0,1986
4424,178650.0,3.0,1.5,1430,1.0,1430,0,1953
4425,87500.0,2.0,1.0,780,1.0,780,0,1948
4426,282508.888889,3.0,1.0,1180,1.5,1180,0,1946
4427,450385.714286,3.0,2.0,1300,1.0,900,400,1993
4429,532500.0,2.0,1.75,2050,1.0,2050,0,1950
4430,408900.0,3.0,1.75,2930,1.0,2030,900,1993
4431,156766.666667,2.0,1.0,1500,1.5,880,620,1928
4433,308830.769231,2.0,1.0,810,1.0,810,0,1919
4434,484991.666667,4.0,2.75,2320,2.0,2320,0,2012
4435,287919.782609,2.0,1.0,1090,1.0,730,360,1942
4436,247875.0,2.0,1.0,1000,1.0,1000,0,1942
4437,309487.5,3.0,2.5,2260,2.0,2260,0,1994
4438,173666.666667,4.0,1.0,1290,1.5,1290,0,1957
4439,237481.25,3.0,2.0,2120,1.0,2120,0,1991
4440,326983.333333,3.0,2.25,1490,2.0,1490,0,2009
4441,790000.0,4.0,2.5,2310,2.0,2310,0,2013
4442,0.0,1.0,1.0,720,1.0,720,0,1940
4443,678333.333333,3.0,2.5,1840,1.0,920,920,1926
4444,542804.75,5.0,2.75,2910,1.0,1590,1320,1977
4445,723243.75,4.0,2.75,3270,2.0,3270,0,2014
4446,667781.25,5.0,2.75,3040,2.0,3040,0,1993
4447,108333.333333,3.0,1.0,1200,1.0,1200,0,1969
4448,0.0,5.0,2.75,2740,1.5,1670,1070,1925
4449,535000.0,4.0,2.25,2290,2.0,2120,170,1958
4450,596165.428571,4.0,2.0,2580,1.0,1300,1280,1950
4451,269187.5,3.0,1.75,1590,1.5,1590,0,1926
4452,148612.5,3.0,1.0,1040,2.0,1040,0,1942
4453,0.0,3.0,1.0,1300,1.0,1300,0,1952
4454,0.0,5.0,2.5,2090,2.0,2090,0,1998
4455,341166.666667,5.0,2.75,2670,2.0,2670,0,2014
4456,132500.0,4.0,1.0,1540,1.5,1540,0,1923
4457,557125.0,4.0,2.75,3370,2.0,3370,0,1991
4458,228944.444444,3.0,1.75,1730,1.0,1730,0,1972
4459,592105.714286,3.0,2.5,1640,2.0,1640,0,1992
4460,535000.0,4.0,2.25,2980,1.5,2020,960,1935
4461,420642.857143,3.0,2.0,1330,1.0,1330,0,1969
4462,132250.0,4.0,2.25,2192,2.0,2192,0,2006
4463,237227.857143,4.0,2.5,2068,2.0,2068,0,1976
4464,440825.0,3.0,1.75,1980,1.0,1090,890,1910
4466,423050.925926,2.0,1.0,890,1.0,890,0,1923
4468,315368.7,3.0,2.5,3080,2.0,3080,0,1990
4469,417985.714286,4.0,2.25,2070,2.0,2070,0,1977
4470,723243.75,4.0,2.75,3010,2.0,3010,0,2014
4471,259950.0,4.0,2.0,2030,1.0,2030,0,1976
4473,237333.333333,3.0,2.75,2340,1.0,1500,840,1972
4474,426090.0,3.0,2.5,2340,2.0,2340,0,1995
4475,458663.888889,2.0,1.0,1470,1.0,1020,450,1941
4476,812650.0,4.0,2.5,3700,1.0,2620,1080,1988
4477,135333.333333,4.0,1.0,1200,1.5,1200,0,1944
4478,0.0,5.0,2.75,2910,1.0,1510,1400,1979
4479,0.0,5.0,2.0,1910,1.0,1110,800,1951
4480,0.0,3.0,2.5,2880,1.0,1520,1360,1950
4481,0.0,5.0,2.75,3240,2.0,3240,0,2013
4482,387884.615385,3.0,1.75,1590,1.5,970,620,1938
4483,437500.0,5.0,3.5,3690,2.0,2540,1150,2006
4484,641633.333333,3.0,2.5,2480,2.0,2480,0,2000
4485,681965.78125,4.0,2.5,2683,2.0,2683,0,1987
4486,229629.5,2.0,1.0,1100,1.0,1100,0,1947
4487,0.0,4.0,1.0,2080,1.5,1260,820,1926
4488,210614.285714,3.0,2.5,2210,1.0,1450,760,1966
4489,790000.0,4.0,3.25,2420,1.5,1870,550,1911
4490,435500.0,3.0,3.5,1240,2.0,1000,240,2008
4491,738190.857143,3.0,2.5,2300,1.5,1510,790,1930
4492,497333.333333,3.0,1.75,1760,1.0,1230,530,1967
4493,300000.0,3.0,2.0,2020,1.0,1220,800,1957
4494,1036200.0,4.0,3.25,2500,1.5,1960,540,1926
4495,163785.714286,2.0,1.0,760,1.5,760,0,1947
4496,351250.0,4.0,1.75,1580,1.0,1130,450,1947
4497,645325.0,3.0,2.5,2670,2.0,2670,0,2003
4498,171224.8,3.0,1.0,1140,1.0,1140,0,1943
4499,0.0,5.0,3.75,3870,2.0,3870,0,1998
4500,540000.0,3.0,2.75,2750,1.0,1810,940,1978
4501,233166.666667,3.0,2.0,1570,2.0,1050,520,1971
4502,329333.333333,3.0,1.75,1160,1.0,1160,0,1976
4503,225279.428571,3.0,2.25,2110,1.0,1360,750,1973
4504,331366.666667,3.0,2.5,1270,2.0,1270,0,2004
4505,460886.923077,4.0,2.5,3250,2.0,3250,0,2009
4506,337945.75,2.0,1.0,940,1.0,940,0,1910
4507,0.0,4.0,1.5,2310,2.0,2310,0,1968
4508,243069.230769,3.0,1.0,1130,1.0,1130,0,1958
4510,690408.62069,4.0,2.5,3210,2.0,3210,0,1995
4511,592105.714286,3.0,2.5,2650,2.0,2650,0,1994
4512,220083.333333,3.0,1.75,1150,1.0,1150,0,1983
4513,280000.0,3.0,3.0,3910,2.0,3910,0,1985
4514,297857.142857,4.0,2.5,3490,2.0,3490,0,2003
4515,950833.333333,5.0,3.0,3330,2.0,2610,720,1977
4516,323833.333333,4.0,1.0,1940,1.5,1940,0,1947
4517,309000.0,3.0,2.5,1800,2.0,1800,0,2011
4518,248400.0,3.0,1.75,1880,1.0,1330,550,1985
4519,994500.0,4.0,2.25,2870,1.5,1980,890,1905
4520,0.0,4.0,2.5,1960,1.0,980,980,1931
4521,0.0,4.0,1.0,1810,1.0,1410,400,1959
4522,0.0,2.0,2.25,1490,1.5,1490,0,1926
4525,379509.166667,2.0,1.0,880,1.0,880,0,1950
4526,180785.714286,2.0,1.0,2550,1.0,1610,940,1958
4527,950100.0,4.0,2.5,3160,2.0,3160,0,1965
4529,542500.0,5.0,2.75,3831,2.0,3831,0,1959
4530,362750.0,2.0,1.75,1240,1.5,1240,0,1906
4531,234975.0,4.0,2.75,2520,2.0,2520,0,1999
4532,672500.0,4.0,2.25,2420,2.0,2420,0,1973
4533,391400.0,4.0,1.75,1250,1.0,1250,0,1959
4534,0.0,3.0,2.75,1310,1.0,1310,0,1957
4535,198995.0,3.0,1.0,1410,1.0,1410,0,1951
4536,278900.0,3.0,1.0,990,1.0,990,0,1968
4537,171758.333333,3.0,1.0,1000,1.0,1000,0,1991
4538,325187.5,3.0,1.75,2000,1.0,1300,700,1968
4539,190368.75,2.0,1.0,1120,1.0,1120,0,1944
4540,375000.0,5.0,3.25,3370,2.0,3370,0,2001
4541,216000.0,3.0,2.75,2210,2.0,2210,0,2008
4542,0.0,5.0,3.5,2640,2.0,2640,0,2001
4543,360500.0,3.0,2.5,1150,3.0,1150,0,2007
4544,677099.565217,4.0,2.5,2150,2.0,2150,0,1997
4546,289987.5,3.0,1.75,1570,1.0,1080,490,1956
4547,264270.0,3.0,2.5,1630,1.0,1120,510,1978
4548,602761.0,4.0,2.5,2770,2.0,2770,0,1989
4549,251555.555556,3.0,1.0,1750,1.0,1150,600,1956
4550,214750.0,3.0,1.5,1090,1.0,1090,0,1967
4551,258125.0,2.0,1.0,930,1.0,930,0,1924
4552,0.0,4.0,2.0,2100,2.0,2100,0,1965
4553,677099.565217,4.0,2.5,2540,2.0,2540,0,1987
4554,0.0,2.0,1.0,810,1.0,810,0,1959
4555,0.0,2.0,1.5,1520,1.0,1520,0,1951
4556,167500.0,1.0,1.0,690,1.0,690,0,1928
4557,471500.0,4.0,3.0,2370,1.5,1650,720,1916
4558,0.0,4.0,4.25,3500,1.0,2140,1360,1951
4559,464600.0,2.0,1.0,840,1.0,840,0,1924
4560,132250.0,4.0,2.25,1830,2.0,1830,0,1991
4561,433111.111111,3.0,2.25,1370,3.0,1370,0,2005
4562,542500.0,5.0,2.75,2520,1.0,1570,950,1960
4563,0.0,2.0,2.25,2130,1.5,1530,600,1941
4564,368112.5,4.0,2.5,2590,2.0,2590,0,1991
4565,673476.818182,4.0,2.5,1820,2.0,1820,0,1987
4566,558653.846154,3.0,2.5,1530,1.5,1010,520,1928
4568,168333.333333,2.0,1.0,1050,1.5,1050,0,1964
4569,268971.875,4.0,2.5,1954,2.0,1954,0,2005
4570,318000.0,2.0,1.75,1530,1.0,830,700,1916
4571,550607.142857,4.0,2.0,1660,1.5,1660,0,1922
4573,584000.0,3.0,1.75,1490,2.0,1090,400,2008
4574,0.0,3.0,1.0,1520,1.0,1520,0,1956
4576,245000.0,3.0,3.0,2470,2.0,1860,610,1977
4577,287919.782609,2.0,1.0,870,1.0,870,0,1942
4578,672500.0,4.0,2.25,2110,2.0,2110,0,1972
4579,454790.0,2.0,1.75,1990,1.0,1090,900,1952
4580,282508.888889,3.0,1.0,1560,1.0,910,650,1948
4581,473200.0,3.0,1.5,1740,1.5,1640,100,1920
4582,406062.5,2.0,1.0,1290,1.0,1290,0,1906
4583,282766.666667,4.0,2.0,1700,1.0,850,850,1955
4584,486445.833333,3.0,1.75,1880,1.0,1880,0,1984
4585,486895.0,3.0,1.0,1890,1.5,1390,500,1901
4586,430277.777778,3.0,2.25,1620,3.0,1540,80,2009
4587,229629.5,2.0,1.0,770,1.0,770,0,1948
4588,0.0,4.0,2.25,2890,3.0,2890,0,1984
4589,182805.0,3.0,1.0,1040,1.0,800,240,1958
4590,380680.555556,4.0,2.5,2620,2.0,2620,0,1991
4591,396166.666667,3.0,1.75,1880,1.0,940,940,1945
4592,252980.0,4.0,2.5,2530,2.0,2530,0,1993
4593,289373.307692,3.0,2.5,2538,2.0,2538,0,2013
4594,210614.285714,3.0,2.5,1610,2.0,1610,0,1994
4595,308166.666667,3.0,1.75,1510,1.0,1510,0,1954
4596,534333.333333,3.0,2.5,1460,2.0,1460,0,1983
4597,416904.166667,3.0,2.5,3010,2.0,3010,0,2009
4598,203400.0,4.0,2.0,2090,1.0,1070,1020,1974
4599,220600.0,3.0,2.5,1490,2.0,1490,0,1990
